AAAAATAAAAATAAATGG	MEF2A
AAAACCAAAAATAGAGAC	MEF2A
AAAACCGAATATACTTAA	MEF2A
AAAACTATAAATAATAGC	MEF2A
AAAACTATTAATAGGAAG	MEF2A
AAAATAGTAAACAGGCAT	FOXP2
AAACATCGTGACGTATGT	CREB1
AAACCAGTAAACAAGAGA	FOXP2
AAACCCAAAAATAGTAGC	MEF2A
AAACCCCTTGACGTGGTA	CREB1
AAACCCTAAAAAACGCAC	MEF2A
AAACGGGGTGACGCCTGT	CREB1
AAACTGGGTGACGATCCA	CREB1
AAACTTCTTGACGTCGCA	CREB1
AAAGACAGCTGTCATGCA	MYOD1
AAAGCGGGTTACGCGCCT	CREB1
AAAGCTAAAAATAGCATC	MEF2A
AAAGCTAAAAATAGCTCG	MEF2A
AAAGGAGTAAACAAAGGG	FOXP2
AAAGGCACCTGAGTCTGG	MYOD1
AAAGGCACCTGTTTCTAA	MYOD1
AAAGGCTAAAATAGATTA	MEF2A
AAAGTCACCTGTCAGCCG	MYOD1
AAAGTTGAAAAAAGAGCC	MEF2A
AAATCCAAAAATAATCTT	MEF2A
AAATCCACCTGTTCATGA	MYOD1
AAATCTTAAAATAGTATC	MEF2A
AAATGCACCTGTCAAACT	MYOD1
AAATGCAGCTGTGATCTA	MYOD1
AAATGTAAAAATAGAACA	MEF2A
AACAAGCACAAGCATGCC	TP53
AACAAGCCAAGACATGTC	TP53
AACAAGCCCCGACATGTC	TP53
AACAAGCCCGGACATGTT	TP53
AACAAGCCCGGGCATGAA	TP53
AACAAGCCCTGACATGCT	TP53
AACAAGCCTGAACAAGCC	TP53
AACAAGCCTGGACATGCC	TP53
AACAAGCTCGGACATGTC	TP53
AACAAGTCCGGGCATGTC	TP53
AACAAGTCTAGACATGTC	TP53
AACACGCCCGGGCATGTC	TP53
AACAGCACCTGCCCAGTG	MYOD1
AACAGCACCTGTCCGACC	MYOD1
AACAGCACCTGTTAACGC	MYOD1
AACATACCCGGACATGTC	TP53
AACATAGAAAACACAAGG	FOXP2
AACATGACCCGACAAATG	TP53
AACATGACCGGACATGTC	TP53
AACATGCACGGGCATGTA	TP53
AACATGCCAAGGCATGTC	TP53
AACATGCCAGGGCATGTC	TP53
AACATGCCAGGGCATGTT	TP53
AACATGCCCAAGCATGTC	TP53
AACATGCCCACGCATGCG	TP53
AACATGCCCAGACATGCT	TP53
AACATGCCCAGACATGTT	TP53
AACATGCCCAGGCATGTA	TP53
AACATGCCCAGGCATGTC	TP53
AACATGCCCAGGCATGTC	TP53
AACATGCCCAGGCATGTC	TP53
AACATGCCCAGGCATTTT	TP53
AACATGCCCATGCATGTC	TP53
AACATGCCCATGCATGTT	TP53
AACATGCCCCGACAAGTT	TP53
AACATGCCCCGACATGCC	TP53
AACATGCCCCGACATGTT	TP53
AACATGCCCCGACGAGTC	TP53
AACATGCCCCGGCATGTC	TP53
AACATGCCCCGGCATGTT	TP53
AACATGCCCCGGCTTGTT	TP53
AACATGCCCGAACATGTT	TP53
AACATGCCCGGACAAGTG	TP53
AACATGCCCGGACATGCC	TP53
AACATGCCCGGACATGTC	TP53
AACATGCCCGGACTTGTC	TP53
AACATGCCCGGGCATGCT	TP53
AACATGCCCGGGCATGCT	TP53
AACATGCCCGGGCATGTC	TP53
AACATGCCCGGGCATGTT	TP53
AACATGCCCGGGCATGTT	TP53
AACATGCCCGGGCATGTT	TP53
AACATGCCCGGGCATGTT	TP53
AACATGCCCGGTCATGTC	TP53
AACATGCCCGTACATGTT	TP53
AACATGCCCGTACTTGTT	TP53
AACATGCCCGTGCATGCC	TP53
AACATGCCCTGGCATGTC	TP53
AACATGCCGAGACATGTT	TP53
AACATGCCGCAACTTGTT	TP53
AACATGCCGCGGCATGTA	TP53
AACATGCCGGAGCATGTC	TP53
AACATGCCGGGACATGTC	TP53
AACATGCCGGGGCATGTC	TP53
AACATGCCGGGGCATGTT	TP53
AACATGCCGGGGCATGTT	TP53
AACATGCCGGGGCCTGAC	TP53
AACATGCCTACGCATGTT	TP53
AACATGCCTAGACATGTT	TP53
AACATGCCTAGGCATGCC	TP53
AACATGCCTAGGCATGTT	TP53
AACATGCCTAGGCATGTT	TP53
AACATGCCTCGACATGCC	TP53
AACATGCCTGAGCATGTT	TP53
AACATGCCTGCACATGTT	TP53
AACATGCCTGGACAAGTC	TP53
AACATGCCTGGACATGCT	TP53
AACATGCCTGGACATGTC	TP53
AACATGCCTGGACATGTT	TP53
AACATGCCTGGACATGTT	TP53
AACATGCCTGGGCATGTC	TP53
AACATGCCTGGGCATGTC	TP53
AACATGCCTGGGCATGTT	TP53
AACATGCCTGGGCATGTT	TP53
AACATGCCTGGGCTTGTA	TP53
AACATGCCTGGGCTTGTC	TP53
AACATGCCTGTACATGTT	TP53
AACATGCCTGTGCATGTC	TP53
AACATGCGCTAACATGTT	TP53
AACATGCGTGAACATGTC	TP53
AACATGCTCAGACATGTT	TP53
AACATGCTCAGGCATGTC	TP53
AACATGCTCCGACATGTC	TP53
AACATGCTCCGACCTGTC	TP53
AACATGCTCCGGCATGTC	TP53
AACATGCTCGGGCATGTC	TP53
AACATGCTCGGGCATGTT	TP53
AACATGCTCGGGCATGTT	TP53
AACATGCTCGTGCATGAT	TP53
AACATGCTCTGGCATGTA	TP53
AACATGCTCTGGCATGTT	TP53
AACATGCTTAGACAAGTT	TP53
AACATGCTTGAACATGGT	TP53
AACATGCTTGGACATGCC	TP53
AACATGTCAAGGCATGTC	TP53
AACATGTCATGACATGCT	TP53
AACATGTCCAGACATGCA	TP53
AACATGTCCAGGCATGTT	TP53
AACATGTCCAGGCATGTT	TP53
AACATGTCCGAACATGTT	TP53
AACATGTCCGGACATGTA	TP53
AACATGTCCGGACATGTC	TP53
AACATGTCCGGACATGTT	TP53
AACATGTCCGGGCAAGTC	TP53
AACATGTCCGGGCATGAT	TP53
AACATGTCCGGGCATGAT	TP53
AACATGTCCGGGCATGCT	TP53
AACATGTCCGGGCATGTC	TP53
AACATGTCCGGGCCTGTT	TP53
AACATGTCCGGTCATGTA	TP53
AACATGTCCGTACATGTC	TP53
AACATGTCCGTGCATGTC	TP53
AACATGTCCTAGCATGTT	TP53
AACATGTCGAGGCATGTC	TP53
AACATGTCGGAGCATGCC	TP53
AACATGTCGGAGCATGTC	TP53
AACATGTCGTGGCATGTT	TP53
AACATGTCTAGGCATGAC	TP53
AACATGTCTAGGCATGTC	TP53
AACATGTCTAGGCTTGTC	TP53
AACATGTCTGGACATGTC	TP53
AACATGTCTGGGCATGTC	TP53
AACATGTCTGGGCATGTT	TP53
AACATGTGCAGACATGTC	TP53
AACATGTGCGGGCATGTT	TP53
AACATGTTATGACATGCT	TP53
AACATGTTCAGGCAAGCC	TP53
AACATGTTCGGACATGTT	TP53
AACATGTTCGGACATGTT	TP53
AACATGTTCGGGCATGCC	TP53
AACATGTTCTGGCATGTC	TP53
AACATTAAAAATAGAATA	MEF2A
AACCAAATAAACAAAGGA	FOXP2
AACCATAAAAACATCCGG	FOXP2
AACCCCAGCTGTGATTCT	MYOD1
AACCCGCCCGGGCATGTT	TP53
AACCCGGATGACGTTTCC	CREB1
AACCCTAAATATAGATCC	MEF2A
AACCCTGATGACGTCGGC	CREB1
AACCGCACCTGCCTCATC	MYOD1
AACCGCAGCTGTGCTAAA	MYOD1
AACCTCGTTGACGTAGTT	CREB1
AACCTGTACAGGCATGTC	TP53
AACGACGATGACGCCATC	CREB1
AACGACGTTGACGTAACA	CREB1
AACGAGCCCAGGCATGTC	TP53
AACGAGCCCTGACATCTT	TP53
AACGAGTCCGGACATGTG	TP53
AACGGCACCTGTCAAGAA	MYOD1
AACGGCAGCTGTTACGCC	MYOD1
AACGGCGGTGACGTCAAT	CREB1
AACGGTCATGACGCGTAC	CREB1
AACGGTGGTGACGCACCA	CREB1
AACGGTGGTGACGTCCTC	CREB1
AACGTGCCATGACATGTC	TP53
AACGTGCCCAGGCATGTC	TP53
AACGTGCCCATGCATGTC	TP53
AACGTGCCTGAACATGTT	TP53
AACGTGTCCGGGCATGTC	TP53
AACGTGTCGGAACAAGTT	TP53
AACGTGTTCAGACATGTT	TP53
AACGTGTTCCGACATGTA	TP53
AACGTTGATGACGTCCGT	CREB1
AACTCGTAACGACATGCA	TP53
AACTCTGGTGACGTCCCA	CREB1
AACTGCACCTGACCCTCG	MYOD1
AACTGCAGCTGTCATCTC	MYOD1
AACTTGCCCAGACATGCT	TP53
AACTTGCCCTGGCATGTC	TP53
AACTTGCCGGGGCATGTC	TP53
AACTTGCCTCGGCATGTT	TP53
AACTTGCCTGGACATGTA	TP53
AAGACAGTAAACAGGGGT	FOXP2
AAGCAGAGTGACGTATTC	CREB1
AAGCATAGAAATAGATTG	MEF2A
AAGCATGTAAACAATGTC	FOXP2
AAGCCTGGTGACGTATGT	CREB1
AAGCCTGTTGACGAGCAC	CREB1
AAGCTGGATGACGTCACA	CREB1
AAGGCAACCTGTCTCGAC	MYOD1
AAGGCAGTAAACAGGCGA	FOXP2
AAGGGCGGTGACGTCTCC	CREB1
AAGGTGGATGACGTCCCT	CREB1
AAGGTTGGTGACGCACGA	CREB1
AAGTCTAAAAATAGAATT	MEF2A
AAGTGGGATGACGCTTGG	CREB1
AAGTTCAGCTGTCGGGAG	MYOD1
AAGTTGGATGACGAGATA	CREB1
AAGTTTAATGACGAGGTT	CREB1
AAGTTTCATGACGTCACG	CREB1
AATAAAGTAAACAATTAA	FOXP2
AATAACAAGTGTTATTCT	MYOD1
AATAAGGTAAACAGATGT	FOXP2
AATAATAAAAATAGCCTT	MEF2A
AATAATAAGAATAAACAT	MEF2A
AATAGCACCTGCCCATCG	MYOD1
AATAGCACCTGTCTCCAC	MYOD1
AATAGGCCCGGACATGTT	TP53
AATAGTAGCTGTCCAGAA	MYOD1
AATATGTCGAGGCATGAC	TP53
AATATTGTAAACAAACAT	FOXP2
AATCACACCTGTCTTATT	MYOD1
AATCAGTCTAAACATGTC	TP53
AATCATGGTGACGCCTTA	CREB1
AATCCAGTAAACAATTGT	FOXP2
AATCCCAGCTGTTAGATC	MYOD1
AATCCTAAAAATAATAGT	MEF2A
AATCGCACCTGTCGATGG	MYOD1
AATCTAGTAAACAGAACC	FOXP2
AATCTGAAAAACAGAGCG	FOXP2
AATCTGCCGGAGCATGTC	TP53
AATCTGGGTGACGTAAGA	CREB1
AATCTGGTAAACAAGTCA	FOXP2
AATGACAATGACGTATCG	CREB1
AATGACACCTGTCGTGCT	MYOD1
AATGATAAAAATAGCGTT	MEF2A
AATGCCGATGACGCAAAC	CREB1
AATGCTAAATTTACAACC	MEF2A
AATGGCACCTGTGGTCCG	MYOD1
AATGTGAATGACGTACAA	CREB1
AATTAAGTAAACAATCGT	FOXP2
AATTACAGCTGTCGGGGC	MYOD1
AATTCAAGGAATATAATC	MEF2A
AATTCCAAAAATAGACGT	MEF2A
AATTCGGGTGACGAATAG	CREB1
AATTCGGTTTACGTGAAT	CREB1
AATTCTGATGACGTCCCG	CREB1
AATTGCAGCTGTTCTTGC	MYOD1
ACAAAGGTAAACAGAAGT	FOXP2
ACAACCACCTGTCATAGG	MYOD1
ACAAGAGTAAACAGAGTT	FOXP2
ACAAGCACCTGTCGCGGA	MYOD1
ACAAGCACGTGCCCCACG	MYOD1
ACAAGCAGCTGTTACCTT	MYOD1
ACAAGCATCTGTTAAGCG	MYOD1
ACAAGCTCCTGTCGCACC	MYOD1
ACAAGTGTAAACACACGA	FOXP2
ACACAAGTAAACACCAGT	FOXP2
ACACATAAAAATAGATCG	MEF2A
ACACCGCGTGACGTGCTG	CREB1
ACACCTGATGACGTCCGG	CREB1
ACACGGGGTGACGTTATA	CREB1
ACACTCGATGACGTCAAA	CREB1
ACACTGGGTGACGCGTTC	CREB1
ACACTTAAAAATAGTTAA	MEF2A
ACACTTGGTGACGCATGC	CREB1
ACAGACGGTTACGCGGAG	CREB1
ACAGCAAAAAACAGAATT	MEF2A
ACAGGCACCTGTCCCCAG	MYOD1
ACAGGCGGTGACGTTGCT	CREB1
ACAGGTGATGACGTATAC	CREB1
ACAGGTGTAAACAGAAGG	FOXP2
ACAGTCATCTGTAACCAT	MYOD1
ACATAGGATGACGTGGTA	CREB1
ACATCCGGTGACGCCGTT	CREB1
ACATCTAAAAATAGTTTC	MEF2A
ACATCTGTAAATAGACAG	MEF2A
ACATGCACCGGTTTTACC	MYOD1
ACATGCACCTGGCAGTAG	MYOD1
ACATGGGAAAACAGAACA	FOXP2
ACATGGGATGACGCCTTA	CREB1
ACCAAAGTAAACAGACAA	FOXP2
ACCAACACCTGTGTCTGT	MYOD1
ACCACAGTAAACAGGATC	FOXP2
ACCACCACCTGTCTCCTG	MYOD1
ACCAGAGTAAACACCGGC	FOXP2
ACCAGCAGCTGCCCCTCC	MYOD1
ACCATGCCGGGGCATGTT	TP53
ACCCCAGTAAACAGAGTT	FOXP2
ACCCGCAGCTGGCAGGGA	MYOD1
ACCCGGCGTGACGTAATC	CREB1
ACCCTCGGTGACGTCCCA	CREB1
ACCGAGCTTGACGCTCGC	CREB1
ACCGCCACCTGTCACTGA	MYOD1
ACCGCCGATGACGACAAT	CREB1
ACCGGCACCTGTTTTTGT	MYOD1
ACCGGCAGCTGCCCATCT	MYOD1
ACCGTCAATGACGTCAAC	CREB1
ACCTACACCTGAGATCGA	MYOD1
ACCTCTATAAATAGACCC	MEF2A
ACCTCTGATGACGTATCT	CREB1
ACCTGAGTAAACAGTCCT	FOXP2
ACCTGCACCTGGGGCATT	MYOD1
ACCTGCACCTGTCCCAGC	MYOD1
ACCTGCACCTGTTCCCGC	MYOD1
ACCTGCAGCTGTCATGCT	MYOD1
ACCTGTGTAAACAAGGGA	FOXP2
ACCTTATAAAATAGAACG	MEF2A
ACGAAAGTAAACAAGCGC	FOXP2
ACGAACAGCTGTCTGTAG	MYOD1
ACGAATGTAAACAGCTCT	FOXP2
ACGACTAAAAATAGAGGC	MEF2A
ACGACTAAAAATAGGGTT	MEF2A
ACGAGCACACGTTACTTC	MYOD1
ACGAGCAGGTGTCCCCCG	MYOD1
ACGCAGAAAAACACAAGC	FOXP2
ACGCCCGATTACGTATTC	CREB1
ACGCGGGTAAACACAGCG	FOXP2
ACGCGTAAAAACAGTAAT	MEF2A
ACGCGTAGTGACGTAGAT	CREB1
ACGGCCAAGATTAAAAAA	MEF2A
ACGGCGCCTGACGTAACA	CREB1
ACGGCGGTTGACGCGGGC	CREB1
ACGGCTAAAAATACTATC	MEF2A
ACGGCTAAAAATAGAACT	MEF2A
ACGGCTAAAAATAGCCTG	MEF2A
ACGGGCACCTGTCGTTTG	MYOD1
ACGGGTGGTGACGTGTAA	CREB1
ACGGTTGGTGACGCCTTA	CREB1
ACGGTTGGTGACGTGTAC	CREB1
ACGTATGTAAACAGATCA	FOXP2
ACGTCAGTAAACAGTTGT	FOXP2
ACGTCTAAAAATAGAAAT	MEF2A
ACGTCTATAAATATCAAA	MEF2A
ACGTGCACCTGTACCGCA	MYOD1
ACGTGGCATGACGTGCAT	CREB1
ACTACCACCTGTCAAAGG	MYOD1
ACTACTAAAAATAGCAGG	MEF2A
ACTACTATAAATATCAGT	MEF2A
ACTACTGTAAACAGGCTT	FOXP2
ACTAGCAGCTGTTTTAAT	MYOD1
ACTATAGTAAACAGGCAG	FOXP2
ACTATAGTAAACAGGCGT	FOXP2
ACTATCACCTGTGAGTAG	MYOD1
ACTATGGTAAACAGGACG	FOXP2
ACTATTTTAAATGGATTG	MEF2A
ACTCAGGTTGACGCATGG	CREB1
ACTCATGGTGACGTCCTT	CREB1
ACTCCTAAAATTAGAAAC	MEF2A
ACTCCTATATATAGCCTC	MEF2A
ACTCGTAAAAATAGAAAC	MEF2A
ACTCTGAATGACGCGCCT	CREB1
ACTGATGGTGACGTCGTG	CREB1
ACTGCCAGCTGTGCGCCG	MYOD1
ACTGCTAAAAATAAGTGT	MEF2A
ACTGGCACCTGTCGCTGT	MYOD1
ACTGGCGATGACGTGCAC	CREB1
ACTGGGGTAAACAGGAGC	FOXP2
ACTTATGGTGACGTCGTT	CREB1
ACTTATGTAAACACCCGA	FOXP2
ACTTCGGATGACGCACCC	CREB1
ACTTCTAAAAATAGGAGA	MEF2A
ACTTCTAAAAATTGATCG	MEF2A
ACTTCTAAAATTAGCTCG	MEF2A
ACTTGAAAAAACAATTTA	FOXP2
ACTTGCACCTGTGCCGTC	MYOD1
AGAAAAATAAACAATGGA	FOXP2
AGAACCACCTGTGTTCGG	MYOD1
AGAACTAAAAATAGCCTT	MEF2A
AGAACTACCTGTCCTTCA	MYOD1
AGAAGCACCTATCTTGCA	MYOD1
AGAAGCACCTGTCGCAGC	MYOD1
AGAATTGTAAACAGCGTT	FOXP2
AGACAAGTAAACAGATGA	FOXP2
AGACACACCTGTGCCGAT	MYOD1
AGACATGATGACGCCCAC	CREB1
AGACATGTAAACAAAGGC	FOXP2
AGACCCAAAAATATAAGT	MEF2A
AGACCCGATGACGTCCAG	CREB1
AGACCGGGTGACGCCGAC	CREB1
AGACCTAAAAATAGTGCC	MEF2A
AGACGAGTAAACACAGCG	FOXP2
AGACGCAGCTGTACCCAC	MYOD1
AGACGTGATGACGTAACA	CREB1
AGACGTGGTGACGTCGCA	CREB1
AGACGTGTTGACGTGATA	CREB1
AGACTAGTAAACAACATC	FOXP2
AGAGACAAAAATATTAGA	MEF2A
AGAGATATAAACACCTTC	FOXP2
AGAGCAAAAAATAGAATA	MEF2A
AGAGCCACCTGTCACGTC	MYOD1
AGAGCCCAAACTAGAGAG	MEF2A
AGAGCCCGTGACGTATAC	CREB1
AGAGCTAAAAATAAACAC	MEF2A
AGAGCTAAAAATAGAAAT	MEF2A
AGAGCTTAAAATAGACTT	MEF2A
AGAGGCACCTGTCTGGAT	MYOD1
AGAGGGGTTGACGCCACA	CREB1
AGAGTCACCTTTCCGCAG	MYOD1
AGAGTTATAAATAGTACA	MEF2A
AGATATCAAAATAGCCAC	MEF2A
AGATATGTAAACAACAGC	FOXP2
AGATCTAAAAATAGACGA	MEF2A
AGATCTAATTATAGTTCG	MEF2A
AGATCTGGAAATAGGGCC	MEF2A
AGATGCACCCGTCTGTTT	MYOD1
AGATGCAGCTGTCTCTGG	MYOD1
AGATGTGGTGACGCACGA	CREB1
AGATTTAAAAATAACTAA	MEF2A
AGCAAAATAAACACGACA	FOXP2
AGCAAGCTCAGACATGTT	TP53
AGCAAGTACGAGCATGTC	TP53
AGCAAGTCGTAACATGTC	TP53
AGCAATGTAAACACAATT	FOXP2
AGCACCACCTGTCATACT	MYOD1
AGCACGCCCATGCGTGTT	TP53
AGCAGCAGCTGTCGAAAC	MYOD1
AGCATCACCTGTCACTGC	MYOD1
AGCATGCACAGACATGTT	TP53
AGCATGCCCAGACATGTT	TP53
AGCATGCCCAGGCATGTC	TP53
AGCATGCCCAGTCATGTT	TP53
AGCATGCCCGGACATGTC	TP53
AGCATGCCCGGACATGTT	TP53
AGCATGCCCGGGCTTGTC	TP53
AGCATGCCCGTGCATGTC	TP53
AGCATGCCCTAACATGTC	TP53
AGCATGCCTAGACATGCT	TP53
AGCATGCCTGGACATGCT	TP53
AGCATGCTAGGACATGTC	TP53
AGCATGCTCAAGCATGCT	TP53
AGCATGTACCGGCATGTT	TP53
AGCATGTATAGGCATGTA	TP53
AGCATGTCCAGACATGTC	TP53
AGCATGTCCAGACATGTT	TP53
AGCATGTCCAGGCATGTC	TP53
AGCATGTCCGAACATGTA	TP53
AGCATGTCCGAGCATGTT	TP53
AGCATGTCCGGGCATGTT	TP53
AGCATGTCGGGGCATGTT	TP53
AGCATGTCTAGACATGTG	TP53
AGCATGTCTAGGCATGTT	TP53
AGCATGTCTGAGCATATG	TP53
AGCATGTCTGGACATGCT	TP53
AGCATGTCTGGGCATGTC	TP53
AGCCACACCTGTCTATAA	MYOD1
AGCCATGCTGACGCCGTG	CREB1
AGCCATGTAAACAGTGAA	FOXP2
AGCCGCACCTGTACATGA	MYOD1
AGCCGCACCTGTCCCACC	MYOD1
AGCCGCACCTGTGATGGG	MYOD1
AGCCGTATAAACACAATA	FOXP2
AGCCTGCCCACACATGTC	TP53
AGCCTTGGTGACGTCTAG	CREB1
AGCCTTGTAAACAAACTC	FOXP2
AGCGACACCTGTTACATA	MYOD1
AGCGAGGTAAACAAAAAA	FOXP2
AGCGCAGTAAACAAATGG	FOXP2
AGCGCCGGTGACGCTAAA	CREB1
AGCGCTCAAATTGGAAAT	MEF2A
AGCGCTGGAAATATATCG	MEF2A
AGCGGCACCTGTCTGGGA	MYOD1
AGCGGCACCTGTTTTCAC	MYOD1
AGCGGTATAAACACCCTG	FOXP2
AGCGTGCTCGGACATGTT	TP53
AGCGTTGGTTACGCTGAT	CREB1
AGCTAGGTAAACAGATCT	FOXP2
AGCTATGGTGACGTCCCG	CREB1
AGCTCCACCTGTTCTACT	MYOD1
AGCTGCAGTTGTTGAACG	MYOD1
AGCTGTATAAACAACTCC	FOXP2
AGCTTGCTCGGGCATGTC	TP53
AGGACGAAAAATAGAGTC	MEF2A
AGGACTTAAAATAAATTG	MEF2A
AGGAGCACCTGTCGAAAT	MYOD1
AGGAGCACCTGTCGTATT	MYOD1
AGGCAGCATTACGTGCGA	CREB1
AGGCCTGGTGACGTCGCT	CREB1
AGGCGCAGCTGTCAGAGC	MYOD1
AGGCTCGGTGACGACGTA	CREB1
AGGCTCGGTGACGTTTGG	CREB1
AGGGATATAAACAGGTCC	FOXP2
AGGGCTAAAAATAAGTAC	MEF2A
AGGGCTGAATATAGTCCC	MEF2A
AGGGTTAGAAATAGATCC	MEF2A
AGGGTTGATGACGCGGCA	CREB1
AGGTAAGTAAACAGCTGT	FOXP2
AGGTAGGATTACGTAGAT	CREB1
AGGTAGGGTGACGTCGAT	CREB1
AGGTCAGTAAACAGAGGT	FOXP2
AGGTCTGGTTACGTATCC	CREB1
AGGTGCACTTGTCGTGAC	MYOD1
AGGTGGAATGACGTAGAG	CREB1
AGGTTCTAAAATAGACTT	MEF2A
AGGTTTGTAAACACTACG	FOXP2
AGTAAAGTAAACAAATTC	FOXP2
AGTAAAGTAAACAATGCC	FOXP2
AGTACAATAAACAACCGC	FOXP2
AGTACCAAAAATAAGATT	MEF2A
AGTACCGCCTGTCACCTC	MYOD1
AGTACTAAAAATAGAGGA	MEF2A
AGTAGCACCTGTTCCACT	MYOD1
AGTAGCAGGTATTCTGTA	MYOD1
AGTAGCATCTGTCCGCTC	MYOD1
AGTAGTATAAACAAACTT	FOXP2
AGTAGTGTAAACAGGTCA	FOXP2
AGTATGTCTCGACTTGTT	TP53
AGTCAAGTAAACAGCGCG	FOXP2
AGTCATCATGACGTCTTA	CREB1
AGTCATGTAAACAACCGC	FOXP2
AGTCATGTTGACGCGGAT	CREB1
AGTCCCAAAAATAGTTCG	MEF2A
AGTCCCAGCTGTCCCTAT	MYOD1
AGTCCTAAAAATAAAGGA	MEF2A
AGTCCTGAATATATCATC	MEF2A
AGTCCTGTTGACGTGCCG	CREB1
AGTCGGGGTGACGTCGCC	CREB1
AGTCTGTCTGGGCATGTG	TP53
AGTGGCACCTGTCCCTTC	MYOD1
AGTGGCACCTTTCTGAGA	MYOD1
AGTTAAATAAACAACGTC	FOXP2
AGTTACACCTGTTATCCT	MYOD1
AGTTATAAAAATAGCATG	MEF2A
AGTTATGTAAACAACTTG	FOXP2
AGTTCGCATGACGTGCCG	CREB1
AGTTCTAAAAATGGAAAC	MEF2A
AGTTCTATAAACAGGCGT	FOXP2
AGTTCTATAAATAAACAG	MEF2A
AGTTCTCTTGACGTGGAC	CREB1
AGTTCTTAAAATTGATAC	MEF2A
AGTTGCACCTGTCCCGGA	MYOD1
AGTTGCAGCTGTTTGAAA	MYOD1
AGTTGTATTGACGAGAGG	CREB1
AGTTTCTAAAATAGTTTA	MEF2A
AGTTTGGTAAACAGTCAC	FOXP2
ATAAACACCTGTCCCCTA	MYOD1
ATAACTAAAAATAGAATA	MEF2A
ATAACTATAAACATGCTA	MEF2A
ATAACTATAGATAACTCC	MEF2A
ATAAGCACCTGTTCCTCA	MYOD1
ATACAAGTAAACAACATG	FOXP2
ATACAAGTAAACACTAGT	FOXP2
ATACATGTAAACAAATGC	FOXP2
ATACATGTAAACAGCTTT	FOXP2
ATACCTAAAATTATAATA	MEF2A
ATACCTATAAATAGACTC	MEF2A
ATACGGGGTGACGCCGCG	CREB1
ATACGTGTAAACAAATGC	FOXP2
ATACTCCTTGACGTATGC	CREB1
ATACTGGGTGACGCATGT	CREB1
ATACTTGTAAACAGTCTC	FOXP2
ATAGAAATAAACAATGGT	FOXP2
ATAGATAAAAATAGATTG	MEF2A
ATAGATGATGACGCCATT	CREB1
ATAGATGTAAACAGGCCA	FOXP2
ATAGCGGATGACGCCTGC	CREB1
ATAGGGGCTGACGATAAG	CREB1
ATAGTCGATAATAGTAAC	MEF2A
ATAGTTGGTTACGTGGAG	CREB1
ATATAGGGTGACGAAAAA	CREB1
ATATATATAAATAGGTGC	MEF2A
ATATCAATAAACAGTCTC	FOXP2
ATATCCAAAAAAAGGAAA	MEF2A
ATATCGGTTGACGTCCTT	CREB1
ATATCTAAAAATAACTCC	MEF2A
ATATCTAAAAATACCCTA	MEF2A
ATATCTAAAAATAGATTC	MEF2A
ATATGCGGTGACGTCGGC	CREB1
ATCAACACCTGTCTCGCC	MYOD1
ATCAAGTCCGTGCATGTC	TP53
ATCACAATAAACAGGCTT	FOXP2
ATCACTATAAACAATTGG	FOXP2
ATCAGCACCTGTCTGAGG	MYOD1
ATCAGCAGCTGTCCTCAT	MYOD1
ATCAGGGTAAACAAGGAG	FOXP2
ATCATGCCATGACATGTT	TP53
ATCATGCCCCAACTAGTA	TP53
ATCATGCCCGGACATGCC	TP53
ATCATGCCCGGACATGTC	TP53
ATCATGCCGGGGCTTGTG	TP53
ATCATGCGCAGACATGTC	TP53
ATCATGGAAAACAGTCTC	FOXP2
ATCATGTCGCGGCATGTC	TP53
ATCATTGAAAACACTGTG	FOXP2
ATCCACAATGACGCGCGT	CREB1
ATCCATAAAAGTATATAC	MEF2A
ATCCCAAAAAATGGAAGT	MEF2A
ATCCCTGCTGACGTATTG	CREB1
ATCCGCACCTGTCCCGAG	MYOD1
ATCCGCACCTGTTAGTGA	MYOD1
ATCCGCATCTGCTCCATT	MYOD1
ATCCTTGTAAACAGGGTT	FOXP2
ATCGAAGTAAACAGATCC	FOXP2
ATCGAAGTAAACAGGTAA	FOXP2
ATCGACACCTGTTCCAAG	MYOD1
ATCGCAGTAAACAGAACA	FOXP2
ATCGGCACCTGTCGCTCG	MYOD1
ATCGGGGTAAACAAATCC	FOXP2
ATCGGGGTAAACAGGACA	FOXP2
ATCGGGGTTGACGTTCTT	CREB1
ATCGTTAAAAATAAAAAG	MEF2A
ATCTATAAAAATAGAACC	MEF2A
ATCTCCATAAATAGTATC	MEF2A
ATCTCCGATGACGCAGTT	CREB1
ATCTCTGGTGACGCCGAT	CREB1
ATCTGCAGCTGTCCAACG	MYOD1
ATCTTTAAAAATAAACTG	MEF2A
ATGAAAGTAAACAATAAC	FOXP2
ATGAGCAGATGTCCCAAC	MYOD1
ATGCAAGTAAACAACATG	FOXP2
ATGCAGATAAACAAGGGG	FOXP2
ATGCAGCTTGACGCTTGA	CREB1
ATGCCAGTAAACACACCG	FOXP2
ATGCCCGTTGACGTCACT	CREB1
ATGCCTGGTGACGTATTT	CREB1
ATGCGCACCTGAAATCCG	MYOD1
ATGCGCACCTGTCTATTA	MYOD1
ATGCGTAAATATAGACAT	MEF2A
ATGCGTAGTGACGATCGA	CREB1
ATGCTGCATGACGTTCGT	CREB1
ATGCTTGATGACGCAGTT	CREB1
ATGGAAGAAAACAAGGCT	FOXP2
ATGGATAAAAATAAAATT	MEF2A
ATGGCCAAAAATACGGTT	MEF2A
ATGGCTTAAAATAGAACC	MEF2A
ATGGGAGTAAACAAACGG	FOXP2
ATGGGAGTAAACAGACAT	FOXP2
ATGGGCACCTGTCCCAGG	MYOD1
ATGGGCACCTGTCTTTGA	MYOD1
ATGGGGGTTGACGTGCCG	CREB1
ATGGGTCAAAATAGAAAT	MEF2A
ATGGTCACCAGTCGGTAT	MYOD1
ATGGTGGTTGACGCGGGG	CREB1
ATGTACTAAAAAAGCAAT	MEF2A
ATGTATCGTGACGCCAAC	CREB1
ATGTCCACCTGCCTGTTG	MYOD1
ATGTCTAAAAATACAGTG	MEF2A
ATGTCTCAAAATAGATCC	MEF2A
ATGTGGGGTGACGTAGGA	CREB1
ATGTGTCGTGACGCATAT	CREB1
ATGTTTAAAAATATAGTG	MEF2A
ATTAACACCTGTCTATTA	MYOD1
ATTACCAAAAATAGGCTA	MEF2A
ATTACGATAAACAGGAGT	FOXP2
ATTACTGTAAACAAATGC	FOXP2
ATTAGCACCTGTCCTATC	MYOD1
ATTAGCACCTGTCGAGTT	MYOD1
ATTAGTAAAAATAGATTT	MEF2A
ATTAGTGTAAACAAGGAA	FOXP2
ATTCAAATAAACAAAATG	FOXP2
ATTCAGGAAAACAGCCGG	FOXP2
ATTCCTAGTGACGTACTG	CREB1
ATTCGCATCTGTCGCTAA	MYOD1
ATTCGGGTTGACGTTGTG	CREB1
ATTCGTGTAAACAGACTA	FOXP2
ATTCTCACCTGTTAGGAG	MYOD1
ATTCTGGGTTACGCCGTT	CREB1
ATTCTTGGTGACGTTGGC	CREB1
ATTCTTGTAAACAAGGGG	FOXP2
ATTGAAGAAAACAAGGCT	FOXP2
ATTGATATAAATAGGATT	MEF2A
ATTGATCGTGACGACATA	CREB1
ATTGCGGCTGACGTCGAT	CREB1
ATTGCTGGTGACGTCCAC	CREB1
ATTGGCGATGACGTGACC	CREB1
ATTGGTGTTGACGCTTTC	CREB1
ATTGTCAGCTGCCAGTGA	MYOD1
ATTTACACCCGGCATACC	MYOD1
ATTTCTAAAAATAACCTC	MEF2A
ATTTCTCAAAATAGCTTT	MEF2A
ATTTCTGAAATTAGTATC	MEF2A
ATTTCTGTTGACGTCAGT	CREB1
ATTTGCAGCTGTCCTACG	MYOD1
ATTTGCAGCTGTCGACTG	MYOD1
ATTTGTAAACTTAGCTAC	MEF2A
ATTTGTCATGACGACCTC	CREB1
ATTTTCAAAAATAGCCAT	MEF2A
ATTTTCACCTGCCTTTAG	MYOD1
CAAAAAGTAAACACCATT	FOXP2
CAAAACACCTGTGCGACA	MYOD1
CAAAATGTAAACAAGCTT	FOXP2
CAAACAGAAAATAAAAGT	MEF2A
CAAACTAAAGATAATATT	MEF2A
CAAACTATAAAAACCGTG	MEF2A
CAAACTGATAATATATCT	MEF2A
CAACAAGTAAACATAAGA	FOXP2
CAACGAGTAAACACATCA	FOXP2
CAACGCACCTGCCGGTGT	MYOD1
CAACGCACCTGTCCCGGC	MYOD1
CAACGGGGTTACGTCACT	CREB1
CAACGTACTGACGCGAAT	CREB1
CAACTAGTAAACACATGT	FOXP2
CAACTTCGTGACGTTCGG	CREB1
CAAGAAGTAAACAGTTGC	FOXP2
CAAGATGTAAACAGAGGT	FOXP2
CAAGCCGATGACGACTTA	CREB1
CAAGGCAAAAATAACACT	MEF2A
CAAGGCAGCTGTCCACGT	MYOD1
CAAGGTAATGACGTAGCT	CREB1
CAAGGTCGTGACGTAGAC	CREB1
CAAGGTGTAAACAGACGT	FOXP2
CAATAAAAAAATAACCTG	MEF2A
CAATAGGTAAACAGAGCG	FOXP2
CAATATTGATATAGATAA	MEF2A
CAATCAAGAAATAGTCAG	MEF2A
CAATCTAAAATTAGACCT	MEF2A
CAATCTGAAAATACACCT	MEF2A
CAATGCACCTGTACCCCC	MYOD1
CAATGCAGCTGTGGGTCT	MYOD1
CAATGGGTAAACAAAGTA	FOXP2
CAATGTCGTGACGCGCTT	CREB1
CAATGTGTTGACGCCAAA	CREB1
CAATTTAAAGATAGACCT	MEF2A
CACAACAAAAATAGTGTC	MEF2A
CACAAGCTCCGGCAAGTC	TP53
CACAGTGTAAACAAGTGA	FOXP2
CACATCAACTGTCGATAG	MYOD1
CACATGCCCAGACTTGTC	TP53
CACATGCCCAGGCATGTC	TP53
CACATGCCCGGACATGTC	TP53
CACATGCCCGGACATGTT	TP53
CACATGCCCGGACATGTT	TP53
CACATGCCCGGACTTGTC	TP53
CACATGCCCGGGCATGTC	TP53
CACATGCCCGGGCATGTT	TP53
CACATGCCGAGGCATGTT	TP53
CACATGCCTAGACATGTT	TP53
CACATGCCTGGGCATGTA	TP53
CACATGTCCGGGCATGTC	TP53
CACATGTCCTGACAAGTT	TP53
CACATGTCGGGACATGTC	TP53
CACATGTCGGGGCATGTC	TP53
CACATGTTCTAGCATGTC	TP53
CACCATGGTGACGTGCGT	CREB1
CACCCCGGTGACGCAAAT	CREB1
CACCCCGGTGACGCCATG	CREB1
CACCCTAAATATAGAGGG	MEF2A
CACCGCACCTGGCACCGC	MYOD1
CACCGCACGTGTCCTTGA	MYOD1
CACCTGATAAACAAGACT	FOXP2
CACGAAGTAAACAAGCTA	FOXP2
CACGATATAAACAGCCAC	FOXP2
CACGCCATCTGTCTTATC	MYOD1
CACGCCGTCTGTAAGTTG	MYOD1
CACGGAAAAAACAAATAC	FOXP2
CACGGCACCTGTCACAAC	MYOD1
CACGGCACCTGTCCATAT	MYOD1
CACGGCACCTGTCCTGTC	MYOD1
CACGGCTCCTGTTTTAAG	MYOD1
CACGTCACCTGCCCTATA	MYOD1
CACGTTAAAAATAGAAAT	MEF2A
CACGTTCAAAATAGCACC	MEF2A
CACTAAGTAAACAACGTG	FOXP2
CACTAGGATGACGTGGCC	CREB1
CACTAGGTAAACAAGCTG	FOXP2
CACTATTAAAATAGCATA	MEF2A
CACTGAGTAAACAGTAAG	FOXP2
CACTGCACCTGTCCGACC	MYOD1
CACTGCACCTGTCCGCGT	MYOD1
CACTGCACCTGTCGATGT	MYOD1
CACTGCACCTGTCGCGTG	MYOD1
CACTGTGGTGACGTCAGA	CREB1
CACTTGCCCAGGCATGTT	TP53
CACTTGCCCGGGCATGAA	TP53
CACTTGGTAAACAAACTG	FOXP2
CACTTTAAAAATAGTATA	MEF2A
CAGAAAGTAAACAGATCG	FOXP2
CAGAACTAAAATATGAGC	MEF2A
CAGACCACCTGTCTGGAT	MYOD1
CAGACTAAAAACAGATAG	MEF2A
CAGAGCACCTGTCTCTAA	MYOD1
CAGAGCACCTGTTCGCGA	MYOD1
CAGCCTGATGACGTAGAG	CREB1
CAGCGAGTAAACATTGCA	FOXP2
CAGCGCACCTGCTTTTGG	MYOD1
CAGCGGCGTGACGCCTTC	CREB1
CAGCTGGATGACGTCATT	CREB1
CAGCTTGCTGACGTGGCC	CREB1
CAGGAAGTAAACAAACTT	FOXP2
CAGGCTAAAATCAGGCGT	MEF2A
CAGGTCGGTTACGTCACC	CREB1
CAGGTGCCTGACGCCGGG	CREB1
CAGTCTAAAAATAACTCG	MEF2A
CAGTGCACCTGTTTGTTC	MYOD1
CAGTGGAGTGACGCCATC	CREB1
CATAAAACCTGTCCCCTG	MYOD1
CATAAAATAAACAGGCTG	FOXP2
CATAAAGTAAACAAAGAT	FOXP2
CATAATATAAACAAAGTA	FOXP2
CATAATCAAAATAGATTT	MEF2A
CATACAAAAAATAGCTAA	MEF2A
CATACTAAAAATAGCCAG	MEF2A
CATAGCACCTGGTAGGAA	MYOD1
CATAGCAGCTGTTTTCTT	MYOD1
CATATTAAAAATAGCGCC	MEF2A
CATCAGCGTGACGTGTCG	CREB1
CATCATGTTGACGCCTAA	CREB1
CATCCCACCTGTTGTATT	MYOD1
CATCCGGGTGACGTCCTA	CREB1
CATCCGGTTGACGCCTTA	CREB1
CATCGTGATGACGCCCTG	CREB1
CATCGTGATGACGCGGTT	CREB1
CATCTTGGTGACGTGTGG	CREB1
CATGACGGTTACGCTACG	CREB1
CATGATAATGACGCCCCG	CREB1
CATGCAGTAAACACGTTA	FOXP2
CATGCGCGTGACGTCGGG	CREB1
CATGCTAAAAATAGAGTT	MEF2A
CATGCTGAAAACAGAAAT	MEF2A
CATGCTGCTGACGTGTGG	CREB1
CATGGCACCTGTTACACG	MYOD1
CATGGCGGTGACGCGCAT	CREB1
CATGGGGTAAACAAGGGA	FOXP2
CATGGTGTTGACGCCAGA	CREB1
CATGTGCCTGACGTCGGT	CREB1
CATGTTGTAAACAGCATT	FOXP2
CATTAGGAAAACACTGCG	FOXP2
CATTATAGAAATAGCTTT	MEF2A
CATTCAGTAAACAGGACA	FOXP2
CATTCTAAAAATAGGATG	MEF2A
CATTCTAATAATAGGTAA	MEF2A
CATTCTGTAAACAACTGC	FOXP2
CATTCTGTAAACATCCGG	FOXP2
CATTCTGTTGACGACTGC	CREB1
CATTGCACCTGTTTAATT	MYOD1
CATTGGGTTGACGAAAGA	CREB1
CATTGTATAAACAGACCA	FOXP2
CCAACCAAAAATAGAAGT	MEF2A
CCAACCACCTTTCTAAAA	MYOD1
CCAACTAAAAATAGAAAG	MEF2A
CCAACTAAAAATAGTCTG	MEF2A
CCAACTATATATAGAGCT	MEF2A
CCAAGAGTAAACACATTC	FOXP2
CCAAGCACCTGTCACGGA	MYOD1
CCAAGCACCTGTTCTGAA	MYOD1
CCAATTAAAAATAGATTC	MEF2A
CCACAAATAAACAGCCGC	FOXP2
CCACAAGTAAACACTGAC	FOXP2
CCACATGTAAACAACGCA	FOXP2
CCACATGTAAACACCGCA	FOXP2
CCACATTTAAATATCATG	MEF2A
CCACCTAAAAATAGTCAG	MEF2A
CCACTTGGTGACGCCATG	CREB1
CCAGAAGTAAACAAATCA	FOXP2
CCAGAGGATGACGTACCG	CREB1
CCAGAGGTAAACACTGGG	FOXP2
CCAGATATTGACGTGATT	CREB1
CCAGATGTAAACAAATAC	FOXP2
CCAGCCATCTGTCGGTAA	MYOD1
CCAGCGGATGACGTGGGG	CREB1
CCAGGAGTAAACACCACC	FOXP2
CCAGGCACCTGTTAGCCA	MYOD1
CCAGGTGGTGACGTTTAT	CREB1
CCAGTGGGTGACGTACCC	CREB1
CCATAAGTAAACATATAG	FOXP2
CCATATATAAATAATACT	MEF2A
CCATCTAAAAATAGATAC	MEF2A
CCATCTATAAATAGAAAT	MEF2A
CCATCTTAAAATAGATAA	MEF2A
CCATGGATAAACAGAGGT	FOXP2
CCATTTAAAAATAGATGA	MEF2A
CCCAAAGTAAACAGCTAA	FOXP2
CCCACCACCTGTCGGCAT	MYOD1
CCCACTAAAAATAAATTT	MEF2A
CCCACTAAAAATGTCATC	MEF2A
CCCACTTAAAATAGAAGT	MEF2A
CCCAGCACCTGTCCTCGC	MYOD1
CCCAGCACCTGTTTGACG	MYOD1
CCCATGCCCGGACATGTC	TP53
CCCCAAGTAAACAAAAAC	FOXP2
CCCCAGGTAAACACGACC	FOXP2
CCCCATGGTGACGTGTAT	CREB1
CCCCCAGTAAACAACGTC	FOXP2
CCCCCCAGCTGTCCACCA	MYOD1
CCCCGCGATGACGCCTGG	CREB1
CCCCGGGCTGACGCCAAT	CREB1
CCCCTTGTAAACAGTTTA	FOXP2
CCCGATGATGACGCCCTT	CREB1
CCCGCCAAGTGTCTTGCG	MYOD1
CCCGGCAGCTGTCCTCTT	MYOD1
CCCGTCGTTGACGAACTG	CREB1
CCCGTTAACAATACATAT	MEF2A
CCCTCAGTAAACAGGCTC	FOXP2
CCCTCCAAAAATAATAGA	MEF2A
CCCTCCAAAAATAGTTTG	MEF2A
CCCTCCACCTGGGGTAGC	MYOD1
CCCTCCGTTGACGTCCGA	CREB1
CCCTCGAATGACGTGGTC	CREB1
CCCTGAGTAAACACAAGG	FOXP2
CCCTGCACCTGTCTCCCG	MYOD1
CCCTGCACCTGTGCATTG	MYOD1
CCCTGCAGCTGTCAAGAC	MYOD1
CCGAGCACCTGGCTTACT	MYOD1
CCGAGCACCTGTTGGGGT	MYOD1
CCGCACACGTGTCATACG	MYOD1
CCGCATAGTGACGTTGCC	CREB1
CCGCATATAAACAGCAAA	FOXP2
CCGCATGTAAACAAGGTA	FOXP2
CCGCCTAAAAATAGCGGT	MEF2A
CCGCCTAAAAATAGGTCC	MEF2A
CCGCGCACCTGTCATGGT	MYOD1
CCGCGCCTTGACGCAGAT	CREB1
CCGCGTATTGACGCCGCT	CREB1
CCGCGTGATGACGTAACG	CREB1
CCGCTCGATGACGTATGC	CREB1
CCGCTGGATGACGCACAT	CREB1
CCGGCGGATGACGTCGCG	CREB1
CCGGCTGTTGACGTAATG	CREB1
CCGGGCACCTGTACGAGC	MYOD1
CCGGGGGATGACGCCAAG	CREB1
CCGGGGGTAAACAAGCTA	FOXP2
CCGGGGGTAAACAATTCC	FOXP2
CCGGGTAAAAATACCATG	MEF2A
CCGGGTGATGACGCAGAC	CREB1
CCGGTGGGTGACGCGCAC	CREB1
CCGGTTATAAACAACACT	FOXP2
CCGTCTACAAATATAAAC	MEF2A
CCGTCTCAAAATAAAACC	MEF2A
CCGTCTGAAAATAGACGA	MEF2A
CCGTGAATAAACAATATG	FOXP2
CCGTGCACCTGTCACAAC	MYOD1
CCGTGCGGTGACGCAAGA	CREB1
CCGTGTGTTGACGTAGAA	CREB1
CCTAAAGTAAACAAGTGG	FOXP2
CCTAAAGTAAACAGGTTG	FOXP2
CCTACAATAAACAAGGGA	FOXP2
CCTACTAAAAATACAACC	MEF2A
CCTAGAGTAAACAAAGAT	FOXP2
CCTAGCAGCTGGCTAAGC	MYOD1
CCTATCAAAAATAGCCCT	MEF2A
CCTCAAGTAAACACCGCA	FOXP2
CCTCACAGCTGTCAGGCT	MYOD1
CCTCCCTTAAATAGCCGA	MEF2A
CCTCGCACCTGTCACAAC	MYOD1
CCTCGCACCTGTCAGCAA	MYOD1
CCTCGTGTTGACGTCCAT	CREB1
CCTCTAGTAAACACGAAG	FOXP2
CCTCTGGGTTACGAGGTA	CREB1
CCTGACACCTGTCATTCA	MYOD1
CCTGATGAAAACACTCCA	FOXP2
CCTGCTAAAAATAGTATT	MEF2A
CCTGGGGATGACGTAACT	CREB1
CCTGGTGATGACGCAAGT	CREB1
CCTGTTATAAATAGAGAA	MEF2A
CCTGTTGTAAACAAATGA	FOXP2
CCTTACGATGACGTACGT	CREB1
CCTTATAAAAACAGATTC	FOXP2
CCTTATGTAAACAAGGGA	FOXP2
CCTTCCAGCTGTCAATCA	MYOD1
CCTTGAGTAAACAGATAC	FOXP2
CCTTGCACCTGTCGAGGG	MYOD1
CCTTTGCATGACGCCTGA	CREB1
CCTTTGGTAAACAAATTT	FOXP2
CCTTTTGTAAACAGACCT	FOXP2
CGAAATAAAAATAGCATA	MEF2A
CGAAGCACGTGTTGATCG	MYOD1
CGACAAGTAAACAGCTCT	FOXP2
CGACACGTTGACGTTCAA	CREB1
CGACAGGAAAACAGTCTA	FOXP2
CGACAGGGTGACGCGAAA	CREB1
CGACATCGTGACGCAAAT	CREB1
CGACATGAAAACAAAATT	FOXP2
CGACCTTAAAATAGATCA	MEF2A
CGACGAGTAAACACAAAC	FOXP2
CGACGCAGCTGTTCAATG	MYOD1
CGACGCGATGACGCATGG	CREB1
CGACTGGTAAACAGGTTA	FOXP2
CGACTTGAAAACAGCTAA	FOXP2
CGACTTGATGACGTACCA	CREB1
CGACTTGCTGACGTAACT	CREB1
CGAGAAGTAAACAAGAAC	FOXP2
CGAGATAAAAATAGCAAC	MEF2A
CGAGCCAAAATTAACACA	MEF2A
CGAGCTAAAAATAAAATC	MEF2A
CGAGCTAGAAATAGAGCG	MEF2A
CGAGCTGAATATAGACAA	MEF2A
CGAGCTGTTGACGTGGTG	CREB1
CGAGGCACCTGTCCTCTT	MYOD1
CGAGGGGGTGACGTATAA	CREB1
CGATAAGTAAACAGACTG	FOXP2
CGATCCACCTGTCGTGTT	MYOD1
CGATCCGGTGACGCGTGA	CREB1
CGATCTAAAAATAGCCCT	MEF2A
CGATCTAAAAATAGTAAA	MEF2A
CGATCTAAAATTATACAG	MEF2A
CGATGAGAAAACACATTC	FOXP2
CGATGAGTAAACACAGCC	FOXP2
CGATGCACCTGCTTTAAT	MYOD1
CGATTGGGTGACGTACTA	CREB1
CGCAACACATGTCTATAT	MYOD1
CGCAACACGTGTTCCCCA	MYOD1
CGCAATGTAAACAGAGAT	FOXP2
CGCAGCACCTGGGCAGCC	MYOD1
CGCAGCACCTGTCTTTTG	MYOD1
CGCAGCAGCTGTCGCGCA	MYOD1
CGCATGAAAGGGCATGTT	TP53
CGCATGCCCAGACAAGTT	TP53
CGCATGCCCGGGCATGTA	TP53
CGCATGCCCGGGCATGTC	TP53
CGCATGTCATGACATGTC	TP53
CGCCATGTAAACAGTATC	FOXP2
CGCCCCACCTGTTATGGA	MYOD1
CGCCCCCGTGACGTAGCC	CREB1
CGCCGCACCTGTCAGCCT	MYOD1
CGCCGCACCTGTCGGGCA	MYOD1
CGCCGCACCTGTCGTAAA	MYOD1
CGCGCCACGTGCTATGAA	MYOD1
CGCGCTGGTGACGTCCTG	CREB1
CGCGCTGTTGACGTAAAG	CREB1
CGCGTAGTAAACAGAAAT	FOXP2
CGCGTCACCTATCCTGGT	MYOD1
CGCGTCACCTGGCCTTCA	MYOD1
CGCGTTGATTACGCGAAT	CREB1
CGCGTTGGTGACGTGATG	CREB1
CGCTAAGTAAACATATCA	FOXP2
CGCTATGGTGACGCCATA	CREB1
CGCTCCAGCTGTCCGTTT	MYOD1
CGCTCTATAAATAGTTAC	MEF2A
CGCTCTCAAAATAGCAAC	MEF2A
CGCTGCACCTGTTACGCT	MYOD1
CGCTGCACCTGTTGCGTG	MYOD1
CGCTGTCATGACGCTCTC	CREB1
CGCTTGGGTGACGTGAGG	CREB1
CGCTTTGTAAACAAACCA	FOXP2
CGGAAAGTAAACAAGTCT	FOXP2
CGGAATGTAAACAGGACA	FOXP2
CGGACCAAAAATAGACTC	MEF2A
CGGACCACCTGTCTACTA	MYOD1
CGGACTTAAAATAGGTAG	MEF2A
CGGAGCACCTGGCCGATG	MYOD1
CGGAGCACCTGTCAGTCT	MYOD1
CGGAGCACCTGTCCCTTG	MYOD1
CGGAGCACCTGTCCTTAG	MYOD1
CGGATTGTAAACAAGTCG	FOXP2
CGGATTGTAAACAGGTGT	FOXP2
CGGCATGTAAACAGAGAC	FOXP2
CGGCCCCAAAATAGATGC	MEF2A
CGGCCCGTTGACGACAGA	CREB1
CGGCGCACCTGTCAGAGC	MYOD1
CGGGAAGTAAACAAATCC	FOXP2
CGGGAGGTAAACACTACC	FOXP2
CGGGATGTAAACAAAGGC	FOXP2
CGGGCGGATGACGTCAAA	CREB1
CGGGTTCCTGACGTTGGT	CREB1
CGGTATAAAAATAGACAT	MEF2A
CGGTATGATGACGAAAGC	CREB1
CGGTCTAAAAATAGAGCG	MEF2A
CGGTCTCTTGACGTAAGG	CREB1
CGGTCTTAACATAGGACA	MEF2A
CGGTGCACCTGTTTGGTT	MYOD1
CGGTGGGTAAACACATAA	FOXP2
CGGTTCGGTGACGACATG	CREB1
CGTAAAGAAAACAGGTTA	FOXP2
CGTAACAGCTGTTAGAGT	MYOD1
CGTAATAAAAATAGAACA	MEF2A
CGTACAAAAAATAGCTAA	MEF2A
CGTACCAAAAATAGAATC	MEF2A
CGTACGAAATATAGGAAG	MEF2A
CGTACTGAAAATAAAAGT	MEF2A
CGTAGAGTAAACAATTGC	FOXP2
CGTAGCAAAATTAGCCCA	MEF2A
CGTAGCACCTGTCCCAGT	MYOD1
CGTAGGACCTGTCCGTCC	MYOD1
CGTATTAAAAATAACTCA	MEF2A
CGTCAAGTAAACAGGTTC	FOXP2
CGTCATGTAAACACACGG	FOXP2
CGTCCGGGTGACGTGAAG	CREB1
CGTCCTATAAATAACATG	MEF2A
CGTCCTCAAAATAGACAA	MEF2A
CGTCTTGTAAACAAATGT	FOXP2
CGTGATGGTGACGTATGC	CREB1
CGTGCCACCTGGCTTGAG	MYOD1
CGTGCCACCTGTCCCTAT	MYOD1
CGTGCTAAAAAAAGCATT	MEF2A
CGTGCTAAAAATACCAAT	MEF2A
CGTGCTAAAAATAGCAGC	MEF2A
CGTGCTAAAAATAGTCTA	MEF2A
CGTGGAACCTGCGTCAAT	MYOD1
CGTGGCACCTGTGCCTTC	MYOD1
CGTGGCGGTGACGTACAT	CREB1
CGTGGGACCTGTCTTGTA	MYOD1
CGTGGGGATGACGTTGGG	CREB1
CGTTAAGTAAACAAGTAT	FOXP2
CGTTATATAAACAATGTA	FOXP2
CGTTATATAAATAGAAAT	MEF2A
CGTTATGTAAACAACAGA	FOXP2
CGTTCCACCTGTGCTTGC	MYOD1
CGTTCCATATATAGACCA	MEF2A
CGTTCTAAAATTAGGAAT	MEF2A
CGTTCTACAAATAGGGTA	MEF2A
CGTTGCACCGGTGATCTT	MYOD1
CGTTGCAGCTGTCGAGGG	MYOD1
CGTTGGGTTGACGTGGGG	CREB1
CTAAAAATAAACACAGTA	FOXP2
CTAAGCACCTGTTCTAGT	MYOD1
CTAATCAGCTGTCCTGGT	MYOD1
CTAATTCAAAATAGAACT	MEF2A
CTACATAAAATTAGCTAC	MEF2A
CTACATGGTTACGTATCG	CREB1
CTACCAAAAACTACATGC	MEF2A
CTACCGGGTGACGTCAAC	CREB1
CTACGCGATGACGCCGAG	CREB1
CTACGGGCTGACGTACGT	CREB1
CTACGGGGTGACGCTAAA	CREB1
CTACTGAGTGACGTGTCT	CREB1
CTACTGATTGACGCACGT	CREB1
CTACTTGATGACGTAGCT	CREB1
CTAGACATGTGTCTTATG	MYOD1
CTAGATGTAAACAACATT	FOXP2
CTAGCCAAAAATAGAGCT	MEF2A
CTAGCTGAACCTAAGCCT	MEF2A
CTAGGCACCTGTCCCGAA	MYOD1
CTAGTGGTTGACGCAAAG	CREB1
CTATAAGTAAACAATGTT	FOXP2
CTATAAGTAAACACCGGC	FOXP2
CTATACACAAATAGCTCG	MEF2A
CTATATATAAACAAACCT	FOXP2
CTATCAGTAAACACGCAA	FOXP2
CTATCTAAAAATAGAATA	MEF2A
CTATCTAAAAATAGTCCA	MEF2A
CTATCTAAAAATATACTG	MEF2A
CTATGGGTAAACAGACAA	FOXP2
CTATTGAATGACGCATGT	CREB1
CTATTTAATGACGACTCT	CREB1
CTATTTCGTGACGCAGGA	CREB1
CTCAAGGTAAACACGTGT	FOXP2
CTCAATGTAAACAGTTTG	FOXP2
CTCACCACCTGCCGGCCT	MYOD1
CTCACCACCTGTCACATA	MYOD1
CTCAGAGTAAACAAATCC	FOXP2
CTCAGCACCTGTCTGTGT	MYOD1
CTCAGCAGCTGCCACCCT	MYOD1
CTCATGCCCAGGCTTGTT	TP53
CTCATGCCCGGACATGAC	TP53
CTCATTGTAAACAGACGG	FOXP2
CTCCACATCTGTCCACTG	MYOD1
CTCCATATAAACACAAAT	FOXP2
CTCCATATAAATATGCAG	MEF2A
CTCCGAATAAACAGATCA	FOXP2
CTCCGCACCTGTTATGTA	MYOD1
CTCCGCGCCTGTCTTTTG	MYOD1
CTCCTGGGTGACGAATGT	CREB1
CTCCTTGTTGACGTGCGT	CREB1
CTCGACGATGACGTCCAC	CREB1
CTCGCTAGTGACGAATGA	CREB1
CTCGCTATAAACAGGCGA	FOXP2
CTCGCTGTAAATAGTAAC	MEF2A
CTCGGCACCTGTAGGAGC	MYOD1
CTCGTGGATGACGCTGGT	CREB1
CTCTAAGTAAACACCGCC	FOXP2
CTCTAAGTAAACACGTGG	FOXP2
CTCTACACCTGTCATACC	MYOD1
CTCTACATCTGTAACCGG	MYOD1
CTCTATGTAAACAATTCA	FOXP2
CTCTCTAGTGACGTCACC	CREB1
CTCTGCATCTGTTTACCC	MYOD1
CTCTTTGGTGACGTTCTA	CREB1
CTGAAAGTAAACAAAGAT	FOXP2
CTGAAAGTAAACACGCTC	FOXP2
CTGAAGGAAAACAGTTCA	FOXP2
CTGACAGAAAATAACTTG	MEF2A
CTGACTAAAAATACAAAC	MEF2A
CTGACTAAATATACGCGC	MEF2A
CTGACTAAGAATACATCT	MEF2A
CTGACTAAGAATAGCTCT	MEF2A
CTGAGCACATGTTCCCCT	MYOD1
CTGAGCATCTGTTTCGGC	MYOD1
CTGAGGGTAAACACATTT	FOXP2
CTGCATGTAAACACCGAT	FOXP2
CTGCCAATAAACAGGCCG	FOXP2
CTGCCAGAAAACACTTGT	FOXP2
CTGCCGCGTGACGTTATC	CREB1
CTGCCTGTAAACAATCCC	FOXP2
CTGCGAGTAAACAAATAC	FOXP2
CTGCGCACCTGTCGATCA	MYOD1
CTGCGGGGTGACGTGTCG	CREB1
CTGCGTGATGACGTCTGT	CREB1
CTGCTGAGTGACGTGAGG	CREB1
CTGGACCGTGACGCCCGG	CREB1
CTGGATGATGACGTTTGC	CREB1
CTGGCGCTTGACGCCTGG	CREB1
CTGGCGGTAAACAGTCGC	FOXP2
CTGGCTAAAAATAGATTG	MEF2A
CTGGCTAAAAATATGGGC	MEF2A
CTGGCTAAAATTAACTAC	MEF2A
CTGGCTAATAATAGCATC	MEF2A
CTGGCTAGTGACGACAAT	CREB1
CTGGCTCAAAATAGACTA	MEF2A
CTGGGAATAAACAGGGGA	FOXP2
CTGGGCACCTCTCGCCTC	MYOD1
CTGGGGAGTTACGCTGGC	CREB1
CTGGTTAAAAATAGACTG	MEF2A
CTGGTTAAAAATAGATAC	MEF2A
CTGTCAGTAAACAAACCG	FOXP2
CTGTCTCTAAATAGCAAA	MEF2A
CTGTCTGGTGACGTCCTC	CREB1
CTGTGCAGCTGTTAGCTT	MYOD1
CTTAAAGTAAACAAGCGG	FOXP2
CTTAATAATCATATTAAT	MEF2A
CTTACCAGCTGTCTCAAA	MYOD1
CTTACCATAAATACAATA	MEF2A
CTTACTAAGATTAGAATT	MEF2A
CTTACTGAAAATAGACGG	MEF2A
CTTAGCACCAGTCGTGCT	MYOD1
CTTAGTATAAATAGACCT	MEF2A
CTTATTAAAAATAAGGAG	MEF2A
CTTCACAAAAAGAGCAAG	MEF2A
CTTCATAAAAACAAACCA	FOXP2
CTTCCTAAAAATACGTGA	MEF2A
CTTCGAGTAAACAGAAGA	FOXP2
CTTCGCACCTGTGGTGGA	MYOD1
CTTCGCATCTGTAGCATT	MYOD1
CTTCGCGGTGACGTCCAT	CREB1
CTTCTTGTTGACGTGCCA	CREB1
CTTGATGATGACGCCATC	CREB1
CTTGCAGTAAACAAATTG	FOXP2
CTTGCAGTAAACACATAG	FOXP2
CTTGCCGAAAATAATACT	MEF2A
CTTGCTAAAAATACCCCC	MEF2A
CTTGCTGAAAAGAGCCAG	MEF2A
CTTGGCAACTGTTTCAGG	MYOD1
CTTGGCGATGACGTAATA	CREB1
CTTTAGGTAAACAACCGC	FOXP2
CTTTATGGTGACGTCACG	CREB1
CTTTCCAAGGATAGTCAA	MEF2A
CTTTCCACCTGTGCGCCT	MYOD1
CTTTCCAGCTGTCTCGTC	MYOD1
CTTTCCAGCTGTCTTTTA	MYOD1
CTTTCTTAAAATAAATGG	MEF2A
CTTTGCACCTGTCACCAA	MYOD1
CTTTGCACCTGTGATTTG	MYOD1
CTTTGCACCTGTTTATCA	MYOD1
CTTTGCAGCTGTCTAGTT	MYOD1
CTTTTTAAAAATAGATCC	MEF2A
GAAAAAGTAAACACATTT	FOXP2
GAAACTAAAAATAAAAAT	MEF2A
GAAAGAGTAAACAGGCTC	FOXP2
GAAATAGTAAACAATCTC	FOXP2
GAACAAGTAAACAGACTA	FOXP2
GAACATGGTGACGTCGCC	CREB1
GAACCCGATTACGTCAAC	CREB1
GAACCTATAAATAGCATT	MEF2A
GAACGCACCTGTTACGGT	MYOD1
GAACGCCCCTGTGGTATT	MYOD1
GAACTAGTAAACAAACCG	FOXP2
GAACTGCATGACGCCTAT	CREB1
GAAGACACCTGTTGCTGG	MYOD1
GAAGATAAAAATAGATCC	MEF2A
GAAGATCGTGACGCAACA	CREB1
GAAGCCACCTGTCCTAGA	MYOD1
GAAGCTAAAATTAAAAAC	MEF2A
GAAGCTGATAATAGCCAT	MEF2A
GAAGCTTATAATAGAAAT	MEF2A
GAAGGCGGCTGTTATCTG	MYOD1
GAAGGGGTTGACGTAGAT	CREB1
GAAGGTAGCTGTTCTCTA	MYOD1
GAAGTGGGTGACGTGAAT	CREB1
GAAGTTGGTGACGCCGTT	CREB1
GAATCTCAAAATATAAAG	MEF2A
GAATCTGATTACGCTTGT	CREB1
GAATGCACCTGTCACCTC	MYOD1
GAATTTGAAAAAAAAATT	MEF2A
GAATTTGTAAACAGAGCG	FOXP2
GACAACACCTGTCTGAGG	MYOD1
GACAACGCCTGTTAGTGA	MYOD1
GACAAGCACAGGCATGTC	TP53
GACAAGCACGAACATGTC	TP53
GACAAGCCCGAACATGTC	TP53
GACAAGCCTGGGCATGTT	TP53
GACAAGCTCGGGCATGTT	TP53
GACAAGCTTGGGCATGTC	TP53
GACAAGTCCAGGCATGCT	TP53
GACAAGTCCAGGCATGTT	TP53
GACAAGTCCCGGCATGTC	TP53
GACAAGTCCGGGCATGCC	TP53
GACAAGTCGAGACATGTC	TP53
GACAAGTCGAGACATGTC	TP53
GACAATAAAAATAGTTAG	MEF2A
GACAATATAAACAGAATA	FOXP2
GACACGCCTGGGCATGTT	TP53
GACACGTCCGGGCATGTT	TP53
GACACTAGGAATAGTAGT	MEF2A
GACAGCACCTGTAGCGTT	MYOD1
GACAGCACCTGTTACCAG	MYOD1
GACATGACCGCGCATGTA	TP53
GACATGCAATGACATGTT	TP53
GACATGCACGGACATGTT	TP53
GACATGCACGGACATGTT	TP53
GACATGCATAGGCATGTC	TP53
GACATGCATGGACAAGCC	TP53
GACATGCCAGGACATGTC	TP53
GACATGCCAGGACATGTT	TP53
GACATGCCAGGGCAAGCT	TP53
GACATGCCCAAACCTGCC	TP53
GACATGCCCAGACATGTC	TP53
GACATGCCCAGACTTGCT	TP53
GACATGCCCAGGCATATT	TP53
GACATGCCCAGGCATGTA	TP53
GACATGCCCAGGCATGTA	TP53
GACATGCCCAGGCATGTT	TP53
GACATGCCCAGGCTTTAA	TP53
GACATGCCCATACATGTT	TP53
GACATGCCCATGCATGAC	TP53
GACATGCCCATGCATGTC	TP53
GACATGCCCATGCATGTC	TP53
GACATGCCCCAGCATGTT	TP53
GACATGCCCCAGCATGTT	TP53
GACATGCCCCGACATTTC	TP53
GACATGCCCCGGCATGTT	TP53
GACATGCCCGAGCAAGTC	TP53
GACATGCCCGAGCACGTA	TP53
GACATGCCCGAGCATGCC	TP53
GACATGCCCGAGCATGTC	TP53
GACATGCCCGGACAAGAC	TP53
GACATGCCCGGACAAGCC	TP53
GACATGCCCGGACAAGTC	TP53
GACATGCCCGGACATGTA	TP53
GACATGCCCGGACATGTC	TP53
GACATGCCCGGACATGTG	TP53
GACATGCCCGGACTTGTC	TP53
GACATGCCCGGGCAAGTT	TP53
GACATGCCCGGGCATATG	TP53
GACATGCCCGGGCATGTC	TP53
GACATGCCCGGGCATGTC	TP53
GACATGCCCGGGCATGTC	TP53
GACATGCCCGGGCATGTC	TP53
GACATGCCCGGGCATGTC	TP53
GACATGCCCGGGCATGTT	TP53
GACATGCCCGTGCATGTG	TP53
GACATGCCCTGACATGTT	TP53
GACATGCCGAAACATGTT	TP53
GACATGCCGAGGCATGTC	TP53
GACATGCCGGGACATGTC	TP53
GACATGCCGGGGCATGTT	TP53
GACATGCCTAAACATGTC	TP53
GACATGCCTCCACACGTC	TP53
GACATGCCTGGGCAAGAC	TP53
GACATGCCTGGGCATGCT	TP53
GACATGCCTGGGCATGTC	TP53
GACATGCCTGGGCATGTT	TP53
GACATGCCTGTACATGTT	TP53
GACATGCCTTAACATGTT	TP53
GACATGCCTTGACTTGTC	TP53
GACATGCCTTGGCTTGTC	TP53
GACATGCGCCTACATGTC	TP53
GACATGCGCGGACATGTC	TP53
GACATGCGCGGGCAAGTA	TP53
GACATGCGTAGACATGAC	TP53
GACATGCTCAGACCTGTC	TP53
GACATGCTCCGGCATGTC	TP53
GACATGCTCGGACATGTC	TP53
GACATGCTCGGACATGTC	TP53
GACATGTACGGGCATGTT	TP53
GACATGTCATGACATGTT	TP53
GACATGTCCAAACATGCT	TP53
GACATGTCCAAACATGTT	TP53
GACATGTCCAAGCATGTC	TP53
GACATGTCCAGACATGTC	TP53
GACATGTCCAGACATGTT	TP53
GACATGTCCAGGCATGTT	TP53
GACATGTCCCAACATGCT	TP53
GACATGTCCCTACTTGTC	TP53
GACATGTCCGAACATGTT	TP53
GACATGTCCGCACATGTT	TP53
GACATGTCCGGACATGAT	TP53
GACATGTCCGGACATGCC	TP53
GACATGTCCGGACATGTT	TP53
GACATGTCCGGACTTGTT	TP53
GACATGTCCGGGCATGTA	TP53
GACATGTCCGGGCTTGTT	TP53
GACATGTCCGTGCATAAC	TP53
GACATGTCCGTGCATGCC	TP53
GACATGTCCTGACATGTT	TP53
GACATGTCGAAACATGCT	TP53
GACATGTCGAAGCATGTC	TP53
GACATGTCGCGACATGCT	TP53
GACATGTCGGAACATGTC	TP53
GACATGTCGGGACATGTT	TP53
GACATGTCGGGGCATGTT	TP53
GACATGTCGGGGCTTGTT	TP53
GACATGTCGTGGCATGCA	TP53
GACATGTCTAGACATGTT	TP53
GACATGTCTAGGCATGTC	TP53
GACATGTCTAGGCATGTC	TP53
GACATGTCTGGACATGTT	TP53
GACATGTCTGGGCTTGCC	TP53
GACATGTCTTAACATGCC	TP53
GACATGTGCGTACAAGCT	TP53
GACATGTTCAGGCAAGTT	TP53
GACATGTTCGGACATGTT	TP53
GACATGTTCGGGCATGTT	TP53
GACATGTTGGGACATGTC	TP53
GACATGTTTAAGCATGTC	TP53
GACCAAACCTGTCTATAG	MYOD1
GACCGCGGCTGTCGCGGA	MYOD1
GACCGGAATGACGTCCAG	CREB1
GACCTCGGTGACGTCGCG	CREB1
GACCTGCCAAGACATGTT	TP53
GACCTGTTTCTACAAGAT	TP53
GACGACAGCTGTCGTAGT	MYOD1
GACGAGTACGGGCATGTT	TP53
GACGATGTAAACAAACGC	FOXP2
GACGCGCCCGTACGTGTT	TP53
GACGCTGGTTACGTGCCT	CREB1
GACGGAGAAAATAGATTT	FOXP2
GACGGTCATGACGAATGA	CREB1
GACGGTGATGACGTTTCT	CREB1
GACGGTGTAAACAATGTC	FOXP2
GACGTGCCCAGGCATGTC	TP53
GACGTGCCCTCGCCTGTT	TP53
GACGTGTCCAGGCATGGG	TP53
GACGTGTTTGGGCCTGCT	TP53
GACTAGGAAAACAACGAC	FOXP2
GACTATAAAAATAGACTC	MEF2A
GACTATGTAAACAGATTG	FOXP2
GACTCCACCTGTTCACGT	MYOD1
GACTGGCCCGAGCATGTC	TP53
GACTTGCCCAGGCATGTC	TP53
GACTTGCCCGGGCATGTA	TP53
GACTTGCTTAGACATGTG	TP53
GACTTGCTTAGGCATGTT	TP53
GAGAACACCTGTATTTGT	MYOD1
GAGAGCACCTGTGACCCG	MYOD1
GAGAGCACTTGGCTCTGA	MYOD1
GAGAGCAGCTGTTCCACT	MYOD1
GAGATGGTAAACAACAAG	FOXP2
GAGCATAAAAATAGAAGA	MEF2A
GAGCCAATAAACAAGTCT	FOXP2
GAGCCCAAAAATAACACG	MEF2A
GAGCCCACCTGCCCCAAC	MYOD1
GAGCCCGGTGACGCACTC	CREB1
GAGCCTAAAAATAGATGG	MEF2A
GAGCCTATAAATAGATAC	MEF2A
GAGCCTCTTGACGCTTAG	CREB1
GAGCGGGGTGACGCTAAC	CREB1
GAGCGTGATGACGTATAT	CREB1
GAGCGTGTTGACGCAGAT	CREB1
GAGGATAAAAATAGCTTC	MEF2A
GAGGCCAAATATAGTAAC	MEF2A
GAGGCTATAAACAGAGCG	MEF2A
GAGGGAGTAAACAGGGTG	FOXP2
GAGGGCAACTGTTACACC	MYOD1
GAGGGCACCTGTCCCTTC	MYOD1
GAGGGCTGCTGTTGACTC	MYOD1
GAGGGTGTAAACAGAATG	FOXP2
GAGGTTCGTGACGCGTCT	CREB1
GAGGTTGTAAACACACGA	FOXP2
GAGTAGGGTGACGTAGAA	CREB1
GAGTAGGTAAACAAGTGG	FOXP2
GAGTATTTAAATATAATA	MEF2A
GAGTCTAAAAATAGATTC	MEF2A
GAGTCTAAAAATAGCAAT	MEF2A
GAGTCTAAAAATATAATC	MEF2A
GAGTCTAGAAATAGAAAG	MEF2A
GAGTCTGGTGACGTGTGT	CREB1
GAGTCTGTAAACAGCTCT	FOXP2
GAGTGCACCTGTCTCATT	MYOD1
GAGTGGATAAACAGGGTG	FOXP2
GAGTTCCAAAATAAACGG	MEF2A
GAGTTGATAAACACATAA	FOXP2
GATAACACCTGTCGCGAA	MYOD1
GATAAGCTCGGACATGTC	TP53
GATAAGTCAATACATGTT	TP53
GATACCAGCTGTCCTATT	MYOD1
GATACTATAAATAGCCCC	MEF2A
GATACTCAAAATAGCATG	MEF2A
GATAGCACCTGTGGCGAC	MYOD1
GATATGCCCAGACATGCT	TP53
GATATGCCCAGACATGTC	TP53
GATATGCCCGGGCTTGTT	TP53
GATATGCCTGAACGAGCT	TP53
GATATGCTCGGACATGTC	TP53
GATATGTCGGGACATGTA	TP53
GATCAAGTAAACAGGAGC	FOXP2
GATCATATAAACACTGTC	FOXP2
GATCATGTAAACAAGATC	FOXP2
GATCCTAAAGATAAAGTC	MEF2A
GATCCTGTAAACAAAGTG	FOXP2
GATCGCAGCTGTTTTGTT	MYOD1
GATCGTCGTGACGTCATC	CREB1
GATCTTCGTGACGCTGGT	CREB1
GATGATAAAAATAGTCTC	MEF2A
GATGCCAAAGTTAGAAAT	MEF2A
GATGGCACCTGTTCTGGG	MYOD1
GATGGCAGCTGTTCCTGC	MYOD1
GATGGTGTAAACAAAGGG	FOXP2
GATGTTAAAAATATTTTA	MEF2A
GATGTTGAAAACAGATGG	MEF2A
GATGTTGTTGACGACGGA	CREB1
GATGTTGTTGACGTTACT	CREB1
GATTAAGTAAACAAGCTC	FOXP2
GATTAAGTAAACACAAGC	FOXP2
GATTATGATTACGCCTCT	CREB1
GATTCTAAAAATAGTCAT	MEF2A
GATTCTATAAATAAAGGC	MEF2A
GATTCTATAAATAGCGGC	MEF2A
GATTTTGGTGACGCCACC	CREB1
GCAAAAGTAAACAACGGA	FOXP2
GCAAAAGTAAACACATTG	FOXP2
GCAAAGATAAACAAAGAA	FOXP2
GCAACCACCTGTCTGCTT	MYOD1
GCAATTATAAATAGTCAT	MEF2A
GCACATGTAAACAGATAT	FOXP2
GCACCGGATGACGCACCA	CREB1
GCACCGGGTGACGCGCCT	CREB1
GCACCTAATATTAAATAT	MEF2A
GCACGGATAAACAACGCC	FOXP2
GCACGGGGTGACGTGCGT	CREB1
GCAGACAAAAATAGCATT	MEF2A
GCAGATGTAAACAGCAAG	FOXP2
GCAGATGTTGACGCGTAC	CREB1
GCAGGCAGCTGATAAGCC	MYOD1
GCAGGTGTAAACAAGCCC	FOXP2
GCAGGTGTAAACAATGGC	FOXP2
GCAGTAGTAAACAATAGG	FOXP2
GCAGTTATAAACAATCAT	FOXP2
GCAGTTGATGACGCGTTA	CREB1
GCATAGGATGACGTGAGA	CREB1
GCATATGTAAACAGAATG	FOXP2
GCATATGTAAACAGGTAA	FOXP2
GCATCCAATAATAGCAAA	MEF2A
GCATCCACCTGTCTTAAT	MYOD1
GCATCTAAAAATATGTCT	MEF2A
GCATCTTAAAATAGAAGA	MEF2A
GCATGTCGTGACGCCTGG	CREB1
GCATGTTAAAATAGATCC	MEF2A
GCATTCGTTGACGTCGGC	CREB1
GCCACAGTAAACAGATGC	FOXP2
GCCAGCACCTGTTGTTTG	MYOD1
GCCATGTCCGGACATGTC	TP53
GCCCACACCTGCCGCGGT	MYOD1
GCCCAGGTAAACACACAC	FOXP2
GCCCATGATGACGTCCCC	CREB1
GCCCCCGATGACGAGAGG	CREB1
GCCCCGATTGACGTTTTC	CREB1
GCCCCTAAAAATAGAAAT	MEF2A
GCCCCTAGAAATAGCAAT	MEF2A
GCCCCTCGTGACGTATTC	CREB1
GCCCCTGGTGACGTCTGA	CREB1
GCCCTGGATGACGCCCCA	CREB1
GCCCTTGTAAACAATGGG	FOXP2
GCCGACGTTGACGTTTCT	CREB1
GCCGAGGTAAACAGGGCG	FOXP2
GCCGCCCTAAATAAATAC	MEF2A
GCCGCTCTTGACGTCGAA	CREB1
GCCGGCACCTGTCAGCAC	MYOD1
GCCGGCACCTGTTTCTGA	MYOD1
GCCGGCAGCTGTGAGGCT	MYOD1
GCCGGGGTAAACACTAGC	FOXP2
GCCGTAATAAACAAAGCA	FOXP2
GCCGTTAAAAATAGGCCG	MEF2A
GCCTACAGCTGTCCGATT	MYOD1
GCCTGCACCTGTCAGGGG	MYOD1
GCCTGCACCTGTCGGAAA	MYOD1
GCCTGCAGATGATAGTAA	MYOD1
GCCTGCAGCTGTCTTATA	MYOD1
GCCTGGGATGACGTGCAC	CREB1
GCCTGTGTAAACAGGAAT	FOXP2
GCGAAAGTAAACAACGTC	FOXP2
GCGAGAAGCTGGCCCTGC	MYOD1
GCGAGCACCTGTCGCTTA	MYOD1
GCGAGCAGCTGTCGTATG	MYOD1
GCGAGTTAAAATAAATTC	MEF2A
GCGCAAGTAAACAAAGAA	FOXP2
GCGCCCACCTGTTCCAGC	MYOD1
GCGCCCGATGACGTCCTT	CREB1
GCGCCTAAAAATAGACAC	MEF2A
GCGCGAATAAACAGGAGC	FOXP2
GCGCGCTCCTGTCTCTCC	MYOD1
GCGCGTGGTGACGTCAGG	CREB1
GCGCGTGTAAACAGTGCT	FOXP2
GCGGATGTAAACACTAGC	FOXP2
GCGGCGGCTGACGTCACT	CREB1
GCGGCTAAAAACACTCAC	MEF2A
GCGGCTAATAATAGTTCC	MEF2A
GCGGCTAATGACGTCTCA	CREB1
GCGGCTATAAATACAAAG	MEF2A
GCGGCTGGTGACGTCACT	CREB1
GCGGGGCTTGACGTATAC	CREB1
GCGGGTGAAAACAAATAC	FOXP2
GCGTACGGTGACGTAATT	CREB1
GCGTCGTAAAATAAAACA	MEF2A
GCGTCTAAAAATAAAGCC	MEF2A
GCGTCTAAAAATAGACTA	MEF2A
GCGTCTAAAATTAAACAC	MEF2A
GCGTGTAATGACGTCGCG	CREB1
GCTAATGAAGATAGAACG	MEF2A
GCTACCAATAACACATCA	MEF2A
GCTACTAATTATAAATCA	MEF2A
GCTACTGAAAATAGATAC	MEF2A
GCTAGCAACTGTCTCTAG	MYOD1
GCTAGCACCTGCTAAAAA	MYOD1
GCTAGCTCCTGTCCCCGA	MYOD1
GCTAGGGTAAACAGAAAC	FOXP2
GCTATCGAAAATAGATCT	MEF2A
GCTCAAGTAAACAGATGC	FOXP2
GCTCAGGTAAACAAGGTA	FOXP2
GCTCCCACCTGTCGCATG	MYOD1
GCTCCCAGCTGTCTTCGC	MYOD1
GCTCCTAAAAAAAGGTTA	MEF2A
GCTCCTAAAAATATCCCC	MEF2A
GCTCCTGATGACGCCATG	CREB1
GCTCGCACCTGTCTCATT	MYOD1
GCTCGCACCTGTTCAATG	MYOD1
GCTCGCAGCTGCCCTGAT	MYOD1
GCTCGCAGCTGGCGTGGG	MYOD1
GCTCGCGATTACGCCGAC	CREB1
GCTCGGGGTGACGTATAT	CREB1
GCTGATGTAAACAAAGAT	FOXP2
GCTGCCAAAAATAGATTC	MEF2A
GCTGCCGATGACGTCCAT	CREB1
GCTGGCACCTGCCGTACA	MYOD1
GCTGGCACCTGTACATGA	MYOD1
GCTGGCCGCTGTTCAAAT	MYOD1
GCTGGGCGTTACGTCTTC	CREB1
GCTGGTGGTTACGTATGT	CREB1
GCTTACAAAAATAGCATA	MEF2A
GCTTACGATGACGTACTC	CREB1
GCTTAGGGTGACGTCCGG	CREB1
GCTTATGTAAACAACCAC	FOXP2
GCTTCTAAAAAAAGTTCT	MEF2A
GCTTCTAAGAATAGTGTA	MEF2A
GCTTCTATTGACGTTGCG	CREB1
GCTTCTGATGACGCAACT	CREB1
GCTTGCACCTGTGCGATA	MYOD1
GCTTGCACGTGTCAACGA	MYOD1
GGAACCATAATTAGTCTT	MEF2A
GGAACTAAAAATAGACAC	MEF2A
GGACCCGGTGACGCCGCC	CREB1
GGACCCGTCAATAGCTAC	MEF2A
GGACTGACCTGTCCATTA	MYOD1
GGACTGGAAAACAATCGC	FOXP2
GGACTTGGTGACGTGGTT	CREB1
GGAGAAGTAAACAACGGC	FOXP2
GGAGCAGTAAACAATCGC	FOXP2
GGAGCCACCTGTTCTCCG	MYOD1
GGAGCTGTAAATTGCCTC	MEF2A
GGAGGGACCTGTACTTGC	MYOD1
GGAGTGGCTGACGCATCC	CREB1
GGAGTTCGTGACGTTTTT	CREB1
GGAGTTCTTAAGAATTCG	MEF2A
GGAGTTGTAAACAGTCGC	FOXP2
GGATAAGTAAACAGGCTA	FOXP2
GGATCCGCTGACGTGCGC	CREB1
GGATCCGTTGACGTCAAC	CREB1
GGATCTAAAAACAGACGT	MEF2A
GGATCTAAAAATAACCTG	MEF2A
GGATCTAAAAATAGATTA	MEF2A
GGATCTAAAAATAGCTAC	MEF2A
GGATCTCTAAATAGGCAG	MEF2A
GGATGTATAAACAACTTG	FOXP2
GGATTTGATGACGTAGGC	CREB1
GGATTTGGTGACGTACCC	CREB1
GGCAAAGTAAACAGTGCA	FOXP2
GGCAACAGCTGTCTCAAG	MYOD1
GGCAAGCCCGGGCAGGTC	TP53
GGCAAGGTAAACAGGTCC	FOXP2
GGCACCAAAAATAGTTAC	MEF2A
GGCACCACCTGTCCGCCG	MYOD1
GGCACTAAAAATAGCGCG	MEF2A
GGCAGCACCTGTCCACAT	MYOD1
GGCAGCACCTGTGGAAAA	MYOD1
GGCAGGATAAACAATCTT	FOXP2
GGCATGCCAAGACATGTT	TP53
GGCATGCCAGAGCATGAT	TP53
GGCATGCCCAGACATGTT	TP53
GGCATGCCCCGACATGTT	TP53
GGCATGCCCGGACAAGGT	TP53
GGCATGCCCGGACATGTG	TP53
GGCATGCCCGGACTTGAG	TP53
GGCATGCCCGGGCATGCA	TP53
GGCATGCCCGGGCATGGT	TP53
GGCATGCCCGGGCATGTT	TP53
GGCATGCCCTTACATGTC	TP53
GGCATGCCGGGGCATGTC	TP53
GGCATGCCTAGACATGTC	TP53
GGCATGCCTAGGCATGTC	TP53
GGCATGCCTCGACATGTT	TP53
GGCATGCCTCGGCATGTC	TP53
GGCATGCCTGGACATGTT	TP53
GGCATGCTCGAGCATGTC	TP53
GGCATGCTTAGACAAGTC	TP53
GGCATGCTTGAGCATGTT	TP53
GGCATGTCCGGGCTCGTA	TP53
GGCATGTCGGGACATGTG	TP53
GGCATGTCGGGGCATGTT	TP53
GGCATGTCTGAGCATGTT	TP53
GGCCCAGTAAACAGCTTG	FOXP2
GGCCCCAGTGACGTCGGT	CREB1
GGCCGGAATGACGCAATT	CREB1
GGCCGTGTAAACACAAAG	FOXP2
GGCGAGCCCGGGCATGTT	TP53
GGCGAGGTAAACAGTGCG	FOXP2
GGCGATGTAAACAACCAA	FOXP2
GGCGCCACCTGTTGAGGA	MYOD1
GGCGCTAAAAATAGTATC	MEF2A
GGCGCTAGTGACGCCCTA	CREB1
GGCGGCACCTGTCCCTGG	MYOD1
GGCGTCAGCTGTCCCATG	MYOD1
GGCGTGTCCGCGCATGTT	TP53
GGCTATAACAATAGGTTA	MEF2A
GGCTCCACCTGTCACGTA	MYOD1
GGCTCCCTAGATAGACAC	MEF2A
GGCTGCACCAGTCCCGCG	MYOD1
GGCTGCACCTGTCTGTCA	MYOD1
GGCTGCACCTGTGGCCGG	MYOD1
GGCTGCAGCTGTGTGTTT	MYOD1
GGCTGCGGTGACGCGCAT	CREB1
GGCTGTGTAAACAAATCT	FOXP2
GGCTTGAGTGACGCCCGC	CREB1
GGCTTGCCCGGGCATGCC	TP53
GGCTTGTGCGTGCATGCC	TP53
GGGAAAATAAATACTAGG	FOXP2
GGGAAAGTAAACAGAGCG	FOXP2
GGGACAGTAAACAGACGC	FOXP2
GGGACTCAAAAAAGCAAG	MEF2A
GGGACTCAAAATAGAGTA	MEF2A
GGGACTTAAAAAGGCTAC	MEF2A
GGGAGTAAAGAAAGCCGT	MEF2A
GGGATCACCTGTCCGAAC	MYOD1
GGGCATAAAAATAGCCTT	MEF2A
GGGCATATAAACAGACCG	FOXP2
GGGCATGGTGACGTATTT	CREB1
GGGCCGGGTGACGTCCCA	CREB1
GGGCCGGTAAATAAGTCC	FOXP2
GGGCGCACCTGTTCCTAC	MYOD1
GGGCTAGTAAACAAACTT	FOXP2
GGGCTTAGTGACGTAAAG	CREB1
GGGGATAAAATTAGACCG	MEF2A
GGGGCTATAAATATTCAC	MEF2A
GGGGCTGGTGACGCAGAT	CREB1
GGGGGCACCTGTCCTAGG	MYOD1
GGGGTAATAAACAAACAC	FOXP2
GGGTACACCTGTCTCGGC	MYOD1
GGGTATGTTGACGTCCTA	CREB1
GGGTCTGAAAATAGCCGC	MEF2A
GGGTGAATAAACAGGAAC	FOXP2
GGGTGCAGCTGTCCTCCC	MYOD1
GGGTGCATCTGTCCCTTG	MYOD1
GGTAATAAATATAAAACG	MEF2A
GGTACTATAAAGAGTGTA	MEF2A
GGTACTCAAAATACTTAG	MEF2A
GGTAGCACCTGTTAGACT	MYOD1
GGTAGCAGCTGTCCCTCT	MYOD1
GGTATCAAGAAAAGACCA	MEF2A
GGTATTAAATATAGACAA	MEF2A
GGTCAAATAAACAGGACA	FOXP2
GGTCAGGGTTACGTGTAT	CREB1
GGTCCCACCTGTCTTCTT	MYOD1
GGTCCTGATGACGAGGGA	CREB1
GGTCGAGTAAACACGAGC	FOXP2
GGTCTAGTAAACAATGGG	FOXP2
GGTCTGGATGACGCTCGT	CREB1
GGTCTTGCTGACGCTCAA	CREB1
GGTCTTGTAAACAAGACT	FOXP2
GGTCTTGTAAACAGACCC	FOXP2
GGTGCCGCCTGTTCTAGC	MYOD1
GGTGCGCTTGACGAACCT	CREB1
GGTGGCACCTGTTCAATC	MYOD1
GGTGGGAAAAATAGACTT	MEF2A
GGTGGGAGTGACGTCTTA	CREB1
GGTGGGATAAACAAGCAG	FOXP2
GGTGTGGTAAACAATAGC	FOXP2
GGTTCTAGAAATAGAAAT	MEF2A
GGTTCTGTAAACACAATT	FOXP2
GGTTCTGTAAACACGTCC	FOXP2
GGTTGCAGCTGTCACTAC	MYOD1
GGTTTTAAAAATAGTCAT	MEF2A
GTAAATGTAAACACGAGT	FOXP2
GTAACCAAAAATAAATTC	MEF2A
GTAACTACACATAGCTTA	MEF2A
GTAAGCACCTGTCAAAAT	MYOD1
GTAAGCAGCTGTCTCTGG	MYOD1
GTAATTGTAAACAGCAAC	FOXP2
GTACAGGTAAACACGCAT	FOXP2
GTACAGGTAAACACTGTT	FOXP2
GTACGAGTAAACAACTTC	FOXP2
GTACGAGTAAACAAGTGG	FOXP2
GTACGAGTAAATAGAGAA	FOXP2
GTACTCACCTGTTGCTGT	MYOD1
GTACTGCATGACGTCTTC	CREB1
GTAGAAGTAAACAGGAGG	FOXP2
GTAGAGGAAAACAGGTCG	FOXP2
GTAGATATAAACAGTATA	FOXP2
GTAGCTAAAAATAGTATA	MEF2A
GTAGCTTAAAATAGTCCG	MEF2A
GTAGGGGATGACGCGTTC	CREB1
GTAGTCAATAATAGACTC	MEF2A
GTATAGGTAAACAACGGG	FOXP2
GTATCGGTAAACAACGAC	FOXP2
GTATCTATAAATAGGCTA	MEF2A
GTATCTATAATTAGACGC	MEF2A
GTATCTTAAAATAGCTTG	MEF2A
GTATCTTTAAATAGAGAA	MEF2A
GTATGAACCTGTAATACA	MYOD1
GTATGAGTAAACAAAGCT	FOXP2
GTATGCACCTGTCCCTCG	MYOD1
GTATGCACCTGTCCTAAG	MYOD1
GTATGCACCTGTCGACCA	MYOD1
GTATGCACCTGTCGTGAC	MYOD1
GTATTCGAAAATAAAAAT	MEF2A
GTATTGGCTGACGTATGA	CREB1
GTATTTGGTGACGTAGGA	CREB1
GTCAAAATAAACAGCTGG	FOXP2
GTCAAAGTAAACAAACTG	FOXP2
GTCAATGTAAACAGAGTG	FOXP2
GTCACAAAAAATAACGGC	MEF2A
GTCACCAAAAATACACTT	MEF2A
GTCAGCACCTGTACTTTA	MYOD1
GTCAGCACCTGTCGCGAT	MYOD1
GTCAGCAGCTGTGACGCT	MYOD1
GTCAGCAGCTGTTGCGTC	MYOD1
GTCATAACCTGTCGTTTC	MYOD1
GTCATGCCCCGGCTTGTC	TP53
GTCATGCCCGGGCATGTT	TP53
GTCATGCCGGAGCATGTC	TP53
GTCATGCCGTAACATGTC	TP53
GTCATGCCTGAGCAAGTT	TP53
GTCATGCCTGGACATGGT	TP53
GTCATGCTATGACATGTT	TP53
GTCATGCTCGGACATGCT	TP53
GTCATGTCCGAACATGTC	TP53
GTCATGTCCGAACATGTT	TP53
GTCATGTCTCGGCATGTC	TP53
GTCATGTCTGGGCGTGTT	TP53
GTCCACGGTGACGTAAAG	CREB1
GTCCATGGTGACGAAACA	CREB1
GTCCCAATAAACAAGAAC	FOXP2
GTCCCGCGTGACGCCCGG	CREB1
GTCCCTGGTTACGCTAGT	CREB1
GTCCGAACCTGTCTACGC	MYOD1
GTCCGCACCTGTTGGTTC	MYOD1
GTCCGCAGCTGACGTTTA	MYOD1
GTCCTCACCTGCCATTAT	MYOD1
GTCCTTGATGACGCTACA	CREB1
GTCGAAGTAAACAGGGGC	FOXP2
GTCGACACCTGTGCGGCA	MYOD1
GTCGACACCTGTGTCTAA	MYOD1
GTCGATGTAAACAGCACA	FOXP2
GTCGCGGGTGACGTATGG	CREB1
GTCGGCACCTGTCAATCA	MYOD1
GTCGGCACCTGTTTACCA	MYOD1
GTCGGGGTAAACAATCGG	FOXP2
GTCGTAGAAAACACTCTT	FOXP2
GTCGTGCACGGACAAGCC	TP53
GTCTAAGTAAACAAACCT	FOXP2
GTCTCCACCTGTCGCGTA	MYOD1
GTCTCCCAAAATAGAAAG	MEF2A
GTCTCTAAAAATAATCGT	MEF2A
GTCTGTGGTGACGTACCC	CREB1
GTCTTGCCTAAGCATGTC	TP53
GTGATTAAAACTAATTAG	MEF2A
GTGCAAGTAAACAAATAG	FOXP2
GTGCAGAGTGACGTACCA	CREB1
GTGCAGCGTGACGTCCCG	CREB1
GTGCAGGGTGACGTACGT	CREB1
GTGCATGGTGACGTCTCC	CREB1
GTGCCAGTAAACAAGAGG	FOXP2
GTGCCCGATGACGTGTAT	CREB1
GTGCGCACCTGTACAATT	MYOD1
GTGCGCATCCGTATCTTG	MYOD1
GTGCGCCGTGACGCGGTA	CREB1
GTGCGTAATGACGTGAAT	CREB1
GTGCTCGGTGACGCGGCT	CREB1
GTGGAGGATGACGTACCG	CREB1
GTGGATCATGACGTTGAT	CREB1
GTGGATGAAAACAGAATA	FOXP2
GTGGCCACCTGTCATACT	MYOD1
GTGGCGGGTGACGTCTCG	CREB1
GTGGCGGTAAACAGACTG	FOXP2
GTGGGCAGCTGGCAACGC	MYOD1
GTGGGGGCTGACGTCAAG	CREB1
GTGGGTGGTGACGCTAGT	CREB1
GTGGTCGATGACGTCTCC	CREB1
GTGGTGGATGACGCCGGC	CREB1
GTGGTTAAAAATAAAACG	MEF2A
GTGGTTGATGACGTAAAG	CREB1
GTGGTTGATTACGTATGA	CREB1
GTGGTTTATAATAGTAAG	MEF2A
GTGTAAGTAAACAGATTC	FOXP2
GTGTATAAAACTATGACG	MEF2A
GTGTCCACCTGTCGTAAC	MYOD1
GTGTCTATAAATAGACTA	MEF2A
GTGTCTGCTGACGTCGAG	CREB1
GTGTGAGTAAACAATACC	FOXP2
GTGTGAGTAAACAGGAAT	FOXP2
GTGTGCACCTGCTATTAA	MYOD1
GTGTGTAAAAATAGCCCG	MEF2A
GTGTGTATTGACGTATAG	CREB1
GTGTTAATAAACAGTCTT	FOXP2
GTTAATAAAAATAGCAAC	MEF2A
GTTAATGTAAACAGACCC	FOXP2
GTTACCACCTGTCACTGT	MYOD1
GTTACTAAAGATAGATTG	MEF2A
GTTATGTCTGGGCAAGTA	TP53
GTTATTAAACATAGTGCA	MEF2A
GTTCAAGTAAACAGAGGC	FOXP2
GTTCAGGTAAACAAAAAA	FOXP2
GTTCCCAATAATAATTCT	MEF2A
GTTCCCACCTGTCACAGA	MYOD1
GTTCCTAACAATAGCGTG	MEF2A
GTTCCTCGTGACGCCTGC	CREB1
GTTCGCAGCTGTCCTTCG	MYOD1
GTTCGGGATGACGTCCGA	CREB1
GTTCGTGATGACGTCTCC	CREB1
GTTCTTGATGACGACGAG	CREB1
GTTGATGTTGACGCACCA	CREB1
GTTGCCGGTGACGTCAAC	CREB1
GTTGCGGATGACGTCGTT	CREB1
GTTGCTAAATCTAGCAAC	MEF2A
GTTGCTAATTATAGACTG	MEF2A
GTTGTCACCTGTCAGAAG	MYOD1
GTTTAAATAAACAGAGGT	FOXP2
GTTTATAGAAATAAATGT	MEF2A
GTTTATCATGACGACGCC	CREB1
GTTTATGTAAACAGATCC	FOXP2
GTTTCCAAATATAGACGG	MEF2A
GTTTCCAGCTGTGCCACC	MYOD1
GTTTCCGAAAATAACTTC	MEF2A
GTTTCCGTTGACGTCGTA	CREB1
GTTTCTAAAAAAACACAG	MEF2A
GTTTCTCAAAATAGAACT	MEF2A
GTTTTGGGTGACGCCGAA	CREB1
GTTTTTGTAAACAACATA	FOXP2
TAAAAAGTAAACAAGTAG	FOXP2
TAAAATAAATATAGACAC	MEF2A
TAAACTAGAAATAGAAGA	MEF2A
TAAACTATGAATAGATCC	MEF2A
TAAAGCAGCTGTAACCGG	MYOD1
TAAAGCAGCTGTCGGACA	MYOD1
TAAATAGTAAACAGGCCT	FOXP2
TAAATGGTAAACAAAGCC	FOXP2
TAAATTGAAAATAGCAAC	MEF2A
TAACAGGTAAACAGGACC	FOXP2
TAACATGTTGACGTTCGT	CREB1
TAACCAGAAAACAGAAAT	FOXP2
TAACCGAAAACTATATCC	MEF2A
TAACCTAACTATAGCACC	MEF2A
TAACGGGTTGACGTGTCG	CREB1
TAACGTACCTGTCCGGCC	MYOD1
TAAGACGATTACGCGGCG	CREB1
TAAGATAAAAACAGCCCC	MEF2A
TAAGATGTAAACACCAAG	FOXP2
TAAGCCATAAATAGGAAT	MEF2A
TAAGGCAACTGTCACATA	MYOD1
TAAGGCACCTGTCATCCC	MYOD1
TAAGGCGGTGACGCTGTA	CREB1
TAAGTGGGTGACGTCTAT	CREB1
TAAGTTAAAAATAGATAC	MEF2A
TAATACAGCTGTCTTCCG	MYOD1
TAATATATAAACAGACAC	FOXP2
TAATCTAAAAATAAAATA	MEF2A
TAATCTAAAAATAGGATG	MEF2A
TAATCTGAAAATAGTACC	MEF2A
TAATCTGTAAACAGTTGC	FOXP2
TACAAGCCCCTGCATGTT	TP53
TACAAGCCTTAGCATGCT	TP53
TACAAGTCCTGGCATGTC	TP53
TACACGCCCGTACATGTT	TP53
TACAGAGTAAACAAGGCT	FOXP2
TACATCAAAAATAGTAAA	MEF2A
TACATGCACGGGCATGTC	TP53
TACATGCCCAAGCTTGTC	TP53
TACATGCCCCGGCATGTC	TP53
TACATGCCCGAACATGTC	TP53
TACATGCCCGAGCATGTT	TP53
TACATGCCCGGACATGTT	TP53
TACATGCCCGGGCATGCC	TP53
TACATGCCCGGGCATGTC	TP53
TACATGCCCGGGCTTGCC	TP53
TACATGCCCTGGCAAGTT	TP53
TACATGCCGCTACATGTG	TP53
TACATGCCTAGACATGCC	TP53
TACATGCCTAGGCATGTA	TP53
TACATGCCTGGACGTGTC	TP53
TACATGCCTGGGCAAGTA	TP53
TACATGCCTGGGCATGTT	TP53
TACATGCCTGTGCAAGTC	TP53
TACATGCTAGGGCATGTC	TP53
TACATGCTCAGGCATGTT	TP53
TACATGCTCGGGCATGTC	TP53
TACATGCTGGGGCAGGCC	TP53
TACATGGCCATACATGTC	TP53
TACATGTACGAACATGTT	TP53
TACATGTACGGACATGTT	TP53
TACATGTCAGGACATGCC	TP53
TACATGTCATGGCATGTC	TP53
TACATGTCCAGACATGTT	TP53
TACATGTCCCGGCATGTT	TP53
TACATGTCCGGACATGCT	TP53
TACATGTCCGGGCATGTT	TP53
TACATGTCCTGACATGTT	TP53
TACATGTCTAAGCATGTT	TP53
TACATGTCTCGGCATGTT	TP53
TACATGTCTGGGCATGCC	TP53
TACATGTCTGGGCATGCG	TP53
TACATGTCTGGGCTTGCC	TP53
TACATGTCTTGACATGTC	TP53
TACATGTCTTGACTTGTT	TP53
TACATGTGCTAGCATGTT	TP53
TACATGTTCGGACATGTT	TP53
TACATGTTGGGGCATGTG	TP53
TACATGTTTGGGCATGAC	TP53
TACCGCACCTGTACGTCA	MYOD1
TACCGGGTTGACGCGAGG	CREB1
TACCTCGGTTACGTCTAA	CREB1
TACCTGCCCAAACATGTT	TP53
TACCTGTCCAGACATGCC	TP53
TACGACAAAAATAAAAAC	MEF2A
TACGACACCTGTCCATCA	MYOD1
TACGAGGAAAACACATAC	FOXP2
TACGATGATGACGTCACC	CREB1
TACGATGATTACGTATGT	CREB1
TACGCTAGAAATAGCAAT	MEF2A
TACGGAGTAAACAGGAGA	FOXP2
TACGGCACCTGTCATTGC	MYOD1
TACGTGATTGACGTATAT	CREB1
TACGTGCCCAAACATGTC	TP53
TACGTGCCCGGACATGTC	TP53
TACGTGCTCGGGCATACC	TP53
TACTAAATAAACACGGTC	FOXP2
TACTGCACCTGCGAATCA	MYOD1
TACTGCACCTGTCCGGTT	MYOD1
TACTGCACCTGTCTAGCC	MYOD1
TACTGCCATGACGCTCAC	CREB1
TACTGTGGTGACGTATTC	CREB1
TACTTCAGCTGTTAATCA	MYOD1
TACTTGACCAGGCATGTT	TP53
TACTTGCCACCGCATGTT	TP53
TACTTGCCTGGACATGCT	TP53
TACTTGCTGGGACATGCC	TP53
TAGACACAAAATAGTTGT	MEF2A
TAGACCACCTGTCATCGA	MYOD1
TAGACTATAAATAAACAT	MEF2A
TAGACTGTAAACAACACC	FOXP2
TAGAGTTGAAATAACAAT	MEF2A
TAGCCTGATGACGCAATA	CREB1
TAGCCTTATCATAGCTCC	MEF2A
TAGCGCCATGACGCACTG	CREB1
TAGGATCATTACGTGAAT	CREB1
TAGGCCCAAAGTAGAATG	MEF2A
TAGGCTAAAATTAGAGTA	MEF2A
TAGGTAGTAAACAAGTGT	FOXP2
TAGGTAGTAAACAGGAGG	FOXP2
TAGTAGATAAACACGCGA	FOXP2
TAGTAGGTTGACGTGATT	CREB1
TAGTCCAAAAATAGTCAT	MEF2A
TAGTCCACCTGTCCTAAC	MYOD1
TAGTCGATAAACAAATCG	FOXP2
TAGTCTAAAAATAACCAT	MEF2A
TAGTCTAAAAATGGGATC	MEF2A
TAGTCTGTAAACAAGCCT	FOXP2
TAGTGCAACTGTCCGATG	MYOD1
TAGTGCACCTGTCTCTGA	MYOD1
TAGTGCCCCTGTATAAGA	MYOD1
TAGTTGGATGACGCCTCT	CREB1
TATAACACCTGCCGCTCC	MYOD1
TATAACACCTGGCTCTAG	MYOD1
TATACTAAAAATAGAACA	MEF2A
TATACTGTAAATAGCAAG	MEF2A
TATAGCAACTGTCTGGCG	MYOD1
TATAGCACCTGGCCGTAA	MYOD1
TATATGATAAACAGAGAC	FOXP2
TATATGCCCTGACATGTC	TP53
TATATGTCTAAGCATGTT	TP53
TATATTTAAAATAGAGGC	MEF2A
TATCAAGTAAACAGGCTC	FOXP2
TATCAGGGTGACGCAGAA	CREB1
TATCCAATAAACAAGGGC	FOXP2
TATCCCAAATATAGGCAG	MEF2A
TATCCGGGTGACGTTAGT	CREB1
TATCCTAATTACGTCCTC	CREB1
TATCCTCGTGACGACTCC	CREB1
TATCGCACCTGTGGCATT	MYOD1
TATCGGGCTGACGTATTT	CREB1
TATGACGGTGACGTGTTT	CREB1
TATGATGATGACGCAGCG	CREB1
TATGCTAAAAATAGTAGA	MEF2A
TATGCTAAAAATAGTTCC	MEF2A
TATGCTCGTGACGCGCTT	CREB1
TATGGAGTAAACACCAGG	FOXP2
TATGGCCCCTGGCTCCGA	MYOD1
TATGTTAAAAATAGAATA	MEF2A
TATGTTAGTGACGTCTAT	CREB1
TATGTTGTAAACAGGTCG	FOXP2
TATTAAATAAACAGTCTT	FOXP2
TATTAAGTAAACAAACTT	FOXP2
TATTAGGTAAACAGAAAC	FOXP2
TATTCTAAAAATAGTAGA	MEF2A
TATTCTGATGACGCACGT	CREB1
TATTCTTAAAATAGAATC	MEF2A
TATTGCACCTGTCCCGGG	MYOD1
TATTGGGTAAACAAGTAA	FOXP2
TATTTTAAAAGTAGACAT	MEF2A
TCAACAACCTGTCCCGAC	MYOD1
TCAACCAAGAATAGCAAA	MEF2A
TCAACCACCCGTTCGGGG	MYOD1
TCAACTAAAAATAACCAC	MEF2A
TCAAGAGTAAACAGTCAG	FOXP2
TCAAGTATAAACAATGCC	FOXP2
TCACATGTAAACACAGTA	FOXP2
TCACCAGAAAACAGACCG	FOXP2
TCACCAGTAAACACTGTT	FOXP2
TCACCCGATGACGCATAA	CREB1
TCACCGGCTGACGTAGTG	CREB1
TCAGACGCCGGTGTACAT	MYOD1
TCAGCTATAAATACAAAC	MEF2A
TCAGCTATTGACGTATAT	CREB1
TCAGGCACCTGTTGACAT	MYOD1
TCAGGTGTTGACGTCGGT	CREB1
TCAGTTAAAACCACACGG	MEF2A
TCATAGGTAAACAGCTGA	FOXP2
TCATCAGTAAACATGTGT	FOXP2
TCATGCACCTGTAACACA	MYOD1
TCATGCACCTGTCATAAG	MYOD1
TCATGGCATGACGTGTAG	CREB1
TCATGTAAAACTGGGCCT	MEF2A
TCCAAGATAAACAGGTTA	FOXP2
TCCACCAAAAATAGTAGT	MEF2A
TCCACCCGCTGTTATAGA	MYOD1
TCCAGCACCTGTCATGAT	MYOD1
TCCAGGAGCTGTAGGCAA	MYOD1
TCCATAATAAACACCAGC	FOXP2
TCCATCACCTGTCTAGCG	MYOD1
TCCATGCCAGGCCATGCC	TP53
TCCATTGTAAACAGGCAT	FOXP2
TCCCAAATAAACAAACCA	FOXP2
TCCCCCACCTGTCAGGTG	MYOD1
TCCCCCGTTGACGTAACT	CREB1
TCCCCTGGTGACGCAATC	CREB1
TCCCGCCATGACGTCCTG	CREB1
TCCCTAGTAAACAGGATC	FOXP2
TCCCTGGATGACGTACCT	CREB1
TCCCTTGTAAACAAGGCT	FOXP2
TCCGAAGTAAACAGACCG	FOXP2
TCCGCCAAAAATAGGCAA	MEF2A
TCCGCGGATGACGTAGCG	CREB1
TCCGCTAAAAATATCAGT	MEF2A
TCCGGCACCTGTCAGGAT	MYOD1
TCCGGCAGCTGTGTGTCT	MYOD1
TCCGGTGGTGACGCTGCC	CREB1
TCCGTAGTAAACAAAACC	FOXP2
TCCGTGCCTGACGCCCAA	CREB1
TCCGTTATAAACAGCACA	FOXP2
TCCGTTGGTTACGTCACT	CREB1
TCCGTTGTAAACAATCCC	FOXP2
TCCGTTGTAAACAATTGT	FOXP2
TCCTAAATAAACAAAGAT	FOXP2
TCCTAAGTAAACAATGCG	FOXP2
TCCTGCACCTGTCTTTTG	MYOD1
TCCTGCACCTGTTACTAA	MYOD1
TCCTGTAAAAATAGTAAT	MEF2A
TCCTTGGTAAACAAGTAA	FOXP2
TCGAACACCTGTTTGACA	MYOD1
TCGACTAAAAATAACTGG	MEF2A
TCGACTTAAAATAGTATT	MEF2A
TCGACTTAGAATGGCAAT	MEF2A
TCGAGCACCTGTTAACCA	MYOD1
TCGAGCACCTGTTACGGA	MYOD1
TCGATTATAAACAACCCC	FOXP2
TCGCCCAATGACGTCGGG	CREB1
TCGCCGGGTGACGTTAGC	CREB1
TCGCCTAGAAATAAATAT	MEF2A
TCGCCTGGTGACGTACGA	CREB1
TCGCGAACCTGTCCCCAT	MYOD1
TCGCGCACCTGTCCCTCC	MYOD1
TCGCGCAGCTGTCCTGAC	MYOD1
TCGCGTAATGACGTCTTC	CREB1
TCGGACACCTGTTATCCG	MYOD1
TCGGAGGTAAACAACCTT	FOXP2
TCGGAGGTAAACAGATCT	FOXP2
TCGGCTCGTGACGCCTTT	CREB1
TCGGGCACCTGTGGCATA	MYOD1
TCGGTAGTAAACAGACTG	FOXP2
TCGGTTGATGACGTGTCT	CREB1
TCGTAAGTAAACAGCATC	FOXP2
TCGTCCCAAAATAGATGT	MEF2A
TCGTCTGATGACGTATTC	CREB1
TCGTGCACCTGTCACCCA	MYOD1
TCGTGCACCTGTCTTGGG	MYOD1
TCGTGTGTTGACGCAATT	CREB1
TCGTTGCATGACGTCAGC	CREB1
TCGTTTAAAAATAGGTAC	MEF2A
TCTAAAAAAAACAGAAGA	FOXP2
TCTAACACCTGTCAACAT	MYOD1
TCTAATAAAACTAGATTT	MEF2A
TCTACCAAAAATAGAAAT	MEF2A
TCTACCAAAAATAGCTCT	MEF2A
TCTACCAAAAATAGTATA	MEF2A
TCTAGCACCTGTCGGACC	MYOD1
TCTAGCACCTGTCGTATA	MYOD1
TCTCAAGTAAACAAGTGT	FOXP2
TCTCATGGTGACGTAAGG	CREB1
TCTCCAGTAAACAAAGCA	FOXP2
TCTCCCACCTGTCTTTTC	MYOD1
TCTCCGAGTGACGTCACG	CREB1
TCTCCGGGTTACGTGATT	CREB1
TCTCCGGTTGACGACTTG	CREB1
TCTCCTATAGATAGAAGT	MEF2A
TCTCCTGTAAACAAGCAG	FOXP2
TCTCGTGTAAACAGATGT	FOXP2
TCTCTAGAAAACAGCATT	FOXP2
TCTCTGGTTGACGTGACT	CREB1
TCTGCAAAAAATAGTTTG	MEF2A
TCTGCTAAAAATAGAGAG	MEF2A
TCTGCTCATGACGAAAAT	CREB1
TCTGGCACCTGGCGGTGT	MYOD1
TCTGGCATCTGTCCCTAG	MYOD1
TCTTAAGTAAACAGTATC	FOXP2
TCTTACACCTGTTCAGAT	MYOD1
TCTTCAATAAATAGACGC	MEF2A
TCTTCCACTTGTCCGGAA	MYOD1
TCTTCCGTTGACGTGCCT	CREB1
TCTTCTAAAAATAGATCA	MEF2A
TCTTCTAAAAATAGTTAT	MEF2A
TCTTGCACCTGTCAGCGG	MYOD1
TCTTGCGAAAATAGACTG	MEF2A
TCTTTCCGAAATAGACGT	MEF2A
TCTTTTCGTTACGCACGC	CREB1
TGAAAGGTAAACAGCAGT	FOXP2
TGAACGATAAATAAAATT	MEF2A
TGAACTAAAAAGAGAAAG	MEF2A
TGAAGCACCTGTTCCGAG	MYOD1
TGAAGCAGCTGTCTCTCA	MYOD1
TGAATTAAAAATACAGCC	MEF2A
TGACACACCTGTTTTCCA	MYOD1
TGACCAATAAACAGTTCA	FOXP2
TGACCAGTAAACAAGGCT	FOXP2
TGACCGGTTGACGTAATC	CREB1
TGACCGGTTGACGTGATG	CREB1
TGACGCACCTGTACGAGA	MYOD1
TGACTCGGTGACGCGGTC	CREB1
TGACTTCAAAATAGTTGT	MEF2A
TGAGAAGTAAACAAATCC	FOXP2
TGAGATATAAACAACTAA	FOXP2
TGAGATGGTGACGTCTCG	CREB1
TGAGCCAGCTGTGGGTGC	MYOD1
TGAGCTAAAAATAGATTT	MEF2A
TGAGCTAAAAATAGCATT	MEF2A
TGAGTTGTAAACACATTG	FOXP2
TGATAAGTAAATAAGAGT	FOXP2
TGATACATTGACGTCAAC	CREB1
TGATATAAAAATAGATTG	MEF2A
TGATATGTAAACAACGGT	FOXP2
TGATCTAAATTTATCTTA	MEF2A
TGATGAGTAAACAAATGA	FOXP2
TGATGCGGCTGTTACATC	MYOD1
TGATTAAAAAATAGAATC	MEF2A
TGATTTAATGACGCGTCC	CREB1
TGCAAAGAAAACACTCAC	FOXP2
TGCAAAGTAAACACCCCA	FOXP2
TGCAAGCTGTGGCATGGA	TP53
TGCAATGTAAACAGAACT	FOXP2
TGCACCAAAAATAGCCGC	MEF2A
TGCACGCTCGGGCATGTT	TP53
TGCAGCACCTGTTCAAGC	MYOD1
TGCAGCATCTGTTCCCCT	MYOD1
TGCAGCTCCTGTCGGAAA	MYOD1
TGCATCACCTGTTCCCAT	MYOD1
TGCATGACCGGGCATGCC	TP53
TGCATGCCCAGACAAGTT	TP53
TGCATGCCCGGGCATGTC	TP53
TGCATGCCCGGGCATGTC	TP53
TGCATGCCCGGGCATGTC	TP53
TGCATGCCCGGGCATGTT	TP53
TGCATGCCCGGTCATGTC	TP53
TGCATGCCTGGACATGTT	TP53
TGCATGCTAGGGCAAGTT	TP53
TGCATGTACTGACATGTC	TP53
TGCATGTCCGGGCAAGTC	TP53
TGCATGTCTGGACATGCC	TP53
TGCATGTCTGGACATGTT	TP53
TGCATGTGCTGGCTTGTC	TP53
TGCCATGAAAACAAATAT	FOXP2
TGCCATGGTGACGTCTCA	CREB1
TGCCCCACCTGTCCCCGA	MYOD1
TGCCCCGCTGACGTCTAT	CREB1
TGCCCTTAAAATAACGCG	MEF2A
TGCCGCTCGTGTGACCAT	MYOD1
TGCGCGGATGACGCCTTC	CREB1
TGCGGCACCTGCCACTTA	MYOD1
TGCGGCACCTGTGACCAG	MYOD1
TGCGGCAGCTGTTAGCTG	MYOD1
TGCTAAGTAAACAGTGGT	FOXP2
TGCTAAGTAAACATGGAA	FOXP2
TGCTACACCTGTTGCTGG	MYOD1
TGCTACGATGACGCATGA	CREB1
TGCTCCACCTGTCGTAGG	MYOD1
TGCTCCAGTAATAGAAAA	MEF2A
TGCTCTAAAAATAACAAC	MEF2A
TGCTCTAAAAATAGGTTG	MEF2A
TGCTCTAAATATAGAAGC	MEF2A
TGCTTCAAAAATATTAGG	MEF2A
TGCTTGCACGAACATGTC	TP53
TGGAAAGAAAACAGGATC	FOXP2
TGGAATGAAAATAGTTGC	MEF2A
TGGACTAAAAATATACCC	MEF2A
TGGAGCACCTGTGACAGA	MYOD1
TGGATTAAAAATACACCT	MEF2A
TGGCATGTAAACAGGTGC	FOXP2
TGGCGCAGCTGTCACAAT	MYOD1
TGGCTTATAAACAAACTG	FOXP2
TGGGAAGTAAACACGTGC	FOXP2
TGGGAAGTAAACAGGGTT	FOXP2
TGGGCAGTAAACAGGCTG	FOXP2
TGGGGCACCTGTTCCTCT	MYOD1
TGGGGCACGTGCCTTGCG	MYOD1
TGGGGTATAAACAAGTCA	FOXP2
TGGGGTATAAACACGATG	FOXP2
TGGTAAGTAAACAAACCC	FOXP2
TGGTACACCTGTCGCGGA	MYOD1
TGGTATCTTGACGTAACG	CREB1
TGGTATGTAAACACGCAG	FOXP2
TGGTATGTAAATAAAATT	FOXP2
TGGTCTATAAATAGATAA	MEF2A
TGGTGCACCTGTTACGGG	MYOD1
TGGTGCACCTGTTTTGGT	MYOD1
TGGTGCAGCTGTGTCTAA	MYOD1
TGGTGGGTAAACAGAACG	FOXP2
TGGTTGGTAAACAGGTCT	FOXP2
TGGTTGGTTGACGTATTG	CREB1
TGGTTTAAAAATAGCAAA	MEF2A
TGGTTTAGAAATATATGC	MEF2A
TGTAAGATAAACAATGCC	FOXP2
TGTAATGTAAACACACTA	FOXP2
TGTACTAAAAATATAACT	MEF2A
TGTATCAGCTGTCATATA	MYOD1
TGTCATCATGACGTCAAC	CREB1
TGTCCCATCTGTTCTAAG	MYOD1
TGTCGTGTAAACAATGTT	FOXP2
TGTCGTGTAAACATCATT	FOXP2
TGTCTCAGCTCTCTGTAC	MYOD1
TGTCTGGGTGACGTGACA	CREB1
TGTCTTAATGACGTAGAG	CREB1
TGTGAAGTAAACACGAAG	FOXP2
TGTGACTAAGATACTCTA	MEF2A
TGTGCAGTAAACAGCACG	FOXP2
TGTGCTAAAAATAAATTC	MEF2A
TGTGGCACCTGTCTCAAG	MYOD1
TGTGTTAGTGACGTGAGA	CREB1
TGTTAAACCTGTTGTAGG	MYOD1
TGTTCAGTAAACACGAGC	FOXP2
TGTTCTAAAAATAGCTAC	MEF2A
TGTTGCACCTGTTCGCGA	MYOD1
TGTTGCAGCTGTCCATGC	MYOD1
TGTTGCAGCTGTTATTAT	MYOD1
TGTTGCATCTGTTTCGAG	MYOD1
TGTTTTAAAAATAGCTAC	MEF2A
TTAACCAAAAAAAGATGC	MEF2A
TTAACCACGTGGCGGCTG	MYOD1
TTAACTGTAAACAACAAA	FOXP2
TTAATAAAATAGAGATTC	MEF2A
TTACAGGAAAACAAGATA	FOXP2
TTACCAGTAAACACGGAT	FOXP2
TTACCCACCTGTCTCAAC	MYOD1
TTACCGAGTTACGTGGGT	CREB1
TTACTAGTAAACAAATCG	FOXP2
TTACTCACGTGTCCCCTG	MYOD1
TTAGATCAAAATAGTCTC	MEF2A
TTAGCGGTTGACGACCGA	CREB1
TTAGCTTAAAATAGAGTT	MEF2A
TTAGTGGTTGACGCGCGT	CREB1
TTATCCACCTGTTTCAAG	MYOD1
TTATCCGGTGACGTATGG	CREB1
TTATCTAAAAATAGCTTA	MEF2A
TTATGAGTAAACAGAACC	FOXP2
TTATGCACATGTCAAGAC	MYOD1
TTATGGGGTGACGTACTT	CREB1
TTATGTTAAAATATTCCT	MEF2A
TTATTCAAAAATAGAACC	MEF2A
TTATTCACCTGTCGGGCG	MYOD1
TTCAATATAAACAGATCT	FOXP2
TTCAATGTAAACAGAGTG	FOXP2
TTCACACAAAATATGGGT	MEF2A
TTCACCATAAATAGAGAT	MEF2A
TTCACTACAAATGGATAT	MEF2A
TTCAGAACCGGTGCGTCG	MYOD1
TTCAGCACCTGTCAATAC	MYOD1
TTCAGCACCTGTTCTTGA	MYOD1
TTCAGCACCTGTTGCTAT	MYOD1
TTCAGCAGCTGTCAGCGC	MYOD1
TTCAGCAGCTGTCGGTGA	MYOD1
TTCATGCCCCGGCATATG	TP53
TTCATGCCCGAACATGTT	TP53
TTCATGCCCGGGCAGGTT	TP53
TTCATGTCCGCACATGTT	TP53
TTCATTCAAAATAGTTTC	MEF2A
TTCCAAGTAAACACAGAT	FOXP2
TTCCCCACCTGGCCAATG	MYOD1
TTCCCGGGTGACGTTTCA	CREB1
TTCCCTGTAAACAGCACC	FOXP2
TTCCGAGTAAACATAATG	FOXP2
TTCCGTCGTTACGCCACC	CREB1
TTCCTCACCTGTCCCTCT	MYOD1
TTCCTCAGTGACGTAAGT	CREB1
TTCCTTCGTGACGCCCTT	CREB1
TTCCTTGGTGACGTACTG	CREB1
TTCGACACCTGTCGGATG	MYOD1
TTCGATATAAACAAAGTT	FOXP2
TTCGCCAAGAATAGTAGT	MEF2A
TTCGCGGTTGACGTGGCA	CREB1
TTCGCTAAAAATAGAAAA	MEF2A
TTCGCTAAAAATAGAACA	MEF2A
TTCGGCACCTGTCCCTTG	MYOD1
TTCGTGCATTACGTGCTG	CREB1
TTCGTGGTTTACGTCCCT	CREB1
TTCTATGTAAACAGCGAT	FOXP2
TTCTCCCGCTGTATCGTG	MYOD1
TTCTCGAAAAATAAAGTT	MEF2A
TTCTCTCTTGACGCGCAC	CREB1
TTCTGCACCTGTCGCACT	MYOD1
TTCTTCACCTGTCACTAG	MYOD1
TTCTTCAGCTGTCGTGAT	MYOD1
TTCTTTCATGACGTAGGT	CREB1
TTGAAAGTAAACAGCCTT	FOXP2
TTGACCAAAAATAAAATG	MEF2A
TTGAGAGTAAACAGAGTT	FOXP2
TTGAGCACCTGTCTGTCC	MYOD1
TTGAGCACCTGTTCTTAG	MYOD1
TTGAGCATCTGTGTGTAC	MYOD1
TTGATGGTAAACAAAAAG	FOXP2
TTGATTAAAAATGCATGC	MEF2A
TTGCACGGTGACGTCGTT	CREB1
TTGCAGACCTGTGGGCTT	MYOD1
TTGCCAGTAAACAACACA	FOXP2
TTGCCCGATGACGCCTGA	CREB1
TTGCCGATTGACGTCTTT	CREB1
TTGCCGGTAAACAGGGGG	FOXP2
TTGCCTAATGACGTCCAC	CREB1
TTGCCTGATGACGCCTTA	CREB1
TTGCGAGTAAACAGCACT	FOXP2
TTGCGGAGTGACGCACCA	CREB1
TTGCTCGATGACGCTGCC	CREB1
TTGCTTGATTACGTCCAC	CREB1
TTGGATGATGACGAACCA	CREB1
TTGGCAAAAAATCGTTAT	MEF2A
TTGGCCGGTGACGTGCGG	CREB1
TTGGCCGTAAACAGAACG	FOXP2
TTGGCTAAAAATAGGTCC	MEF2A
TTGGCTGTAAATAGTGCC	MEF2A
TTGGGCACCTGTCATAGA	MYOD1
TTGGGCAGCTGTCATTGT	MYOD1
TTGGTTGTTGACGTCTTC	CREB1
TTGTAGGTAAACAACAGA	FOXP2
TTGTGTAAAAATAGAGCG	MEF2A
TTGTTAGTAAACAGGTTC	FOXP2
TTGTTTGTAAACAAATTT	FOXP2
TTTAATAAAAATAGTCTT	MEF2A
TTTAATTAAAATAGTGCG	MEF2A
TTTACTAAAAACACAATC	MEF2A
TTTACTAAAAATAGTCAC	MEF2A
TTTACTATAAATAGACTG	MEF2A
TTTACTATAAATAGATTT	MEF2A
TTTAGTAAAAACAACGTC	FOXP2
TTTCCTAAAAACAGCAAT	MEF2A
TTTCCTCGTGACGTAACT	CREB1
TTTCGGGGTGACGTCTCA	CREB1
TTTCGTGGTGACGCCGAG	CREB1
TTTCGTGGTGACGCTGTC	CREB1
TTTCTAATAAACAAACTG	FOXP2
TTTCTAATAAACAAGGTT	FOXP2
TTTCTCCGTGACGTGAGT	CREB1
TTTCTTATAAACAACTCG	FOXP2
TTTGAAGTAAACAAAATA	FOXP2
TTTGACACTTGTTTGCTT	MYOD1
TTTGATGATGACGTTTTG	CREB1
TTTGCAGTAAACAGGTCA	FOXP2
TTTGCTAGTGACGCACGC	CREB1
TTTGCTTAAATTAGAGAC	MEF2A
TTTGGAGTAAACACGCGA	FOXP2
TTTGGGCTTGACGTGGTT	CREB1
TTTGTAATAAACAGGAGG	FOXP2
TTTGTCTCCTGTCATTAG	MYOD1
TTTGTTGAAAATAGAAAA	MEF2A
TTTGTTGTAAACAAGATA	FOXP2
TTTTCTAAAAATAGAAAA	MEF2A
TTTTCTAAAAATAGAAAG	MEF2A
TTTTCTGAAAATAGCATG	MEF2A
TTTTGAGTAAACACAAGC	FOXP2
TTTTTAGTAAACAGAGCT	FOXP2
